Date,Flavor ,Sold (Qty),Produced (Qty),Temperature (Avg.),Rain?,Waste (%),Waste (Qty),Revenue/ Profit
2023-01-01,Pepperoni,120,124,77.5,0,0.03,4,720
2023-01-01,Cheese,105,106,77.5,0,0.01,1,630
2023-01-01,Vegetariana,120,126,77.5,0,0.05,6,840
2023-01-01,Primavera,60,61,77.5,0,0.01,1,420
2023-01-01,Napolitana,45,46,77.5,0,0.02,1,315
2023-01-02,Pepperoni,135,138,76.0,0,0.02,3,810
2023-01-02,Cheese,15,15,76.0,0,0.01,0,90
2023-01-02,Vegetariana,75,78,76.0,0,0.04,3,525
2023-01-02,Primavera,45,45,76.0,0,0.01,0,315
2023-01-02,Napolitana,45,46,76.0,0,0.02,1,315
2023-01-03,Pepperoni,45,46,78.0,0,0.03,1,270
2023-01-03,Cheese,90,91,78.0,0,0.01,1,540
2023-01-03,Vegetariana,105,109,78.0,0,0.04,4,735
2023-01-03,Primavera,45,46,78.0,0,0.02,1,315
2023-01-03,Napolitana,60,61,78.0,0,0.02,1,420
2023-01-04,Pepperoni,60,61,78.5,0,0.02,1,360
2023-01-04,Cheese,75,77,78.5,0,0.02,2,450
2023-01-04,Vegetariana,120,124,78.5,0,0.03,4,840
2023-01-04,Primavera,120,125,78.5,0,0.04,5,840
2023-01-04,Napolitana,60,62,78.5,0,0.03,2,420
2023-01-05,Pepperoni,150,152,79.0,0,0.01,2,900
2023-01-05,Cheese,15,15,79.0,0,0.01,0,90
2023-01-05,Vegetariana,90,92,79.0,0,0.02,2,630
2023-01-05,Primavera,120,124,79.0,0,0.03,4,840
2023-01-05,Napolitana,30,31,79.0,0,0.02,1,210
2023-01-06,Pepperoni,150,152,73.0,0,0.01,2,900
2023-01-06,Cheese,30,30,73.0,0,0.01,0,180
2023-01-06,Vegetariana,270,275,73.0,0,0.02,5,1890
2023-01-06,Primavera,75,77,73.0,0,0.02,2,525
2023-01-06,Napolitana,90,92,73.0,0,0.02,2,630
2023-01-07,Pepperoni,120,121,70.0,0,0.01,1,720
2023-01-07,Cheese,75,76,70.0,0,0.01,1,450
2023-01-07,Vegetariana,225,230,70.0,0,0.02,5,1575
2023-01-07,Primavera,105,107,70.0,0,0.02,2,735
2023-01-07,Napolitana,90,92,70.0,0,0.02,2,630
2023-01-08,Pepperoni,15,15,70.5,0,0.03,0,90
2023-01-08,Cheese,15,15,70.5,0,0.01,0,90
2023-01-08,Vegetariana,75,79,70.5,0,0.05,4,525
2023-01-08,Primavera,105,106,70.5,0,0.01,1,735
2023-01-08,Napolitana,60,61,70.5,0,0.02,1,420
2023-01-09,Pepperoni,15,15,72.0,0,0.02,0,90
2023-01-09,Cheese,15,15,72.0,0,0.01,0,90
2023-01-09,Vegetariana,105,109,72.0,0,0.04,4,735
2023-01-09,Primavera,45,45,72.0,0,0.01,0,315
2023-01-09,Napolitana,30,31,72.0,0,0.02,1,210
2023-01-10,Pepperoni,60,62,72.0,0,0.03,2,360
2023-01-10,Cheese,90,91,72.0,0,0.01,1,540
2023-01-10,Vegetariana,60,62,72.0,0,0.04,2,420
2023-01-10,Primavera,60,61,72.0,0,0.02,1,420
2023-01-10,Napolitana,15,15,72.0,0,0.02,0,105
2023-01-11,Pepperoni,15,15,68.0,0,0.02,0,90
2023-01-11,Cheese,75,77,68.0,0,0.02,2,450
2023-01-11,Vegetariana,315,324,68.0,0,0.03,9,2205
2023-01-11,Primavera,60,62,68.0,0,0.04,2,420
2023-01-11,Napolitana,15,15,68.0,0,0.03,0,105
2023-01-12,Pepperoni,60,61,69.5,0,0.01,1,360
2023-01-12,Cheese,15,15,69.5,0,0.01,0,90
2023-01-12,Vegetariana,120,122,69.5,0,0.02,2,840
2023-01-12,Primavera,60,62,69.5,0,0.03,2,420
2023-01-12,Napolitana,60,61,69.5,0,0.02,1,420
2023-01-13,Pepperoni,135,136,70.5,0,0.01,1,810
2023-01-13,Cheese,90,91,70.5,0,0.01,1,540
2023-01-13,Vegetariana,345,352,70.5,0,0.02,7,2415
2023-01-13,Primavera,210,214,70.5,0,0.02,4,1470
2023-01-13,Napolitana,120,122,70.5,0,0.02,2,840
2023-01-14,Pepperoni,105,106,55.0,0,0.01,1,630
2023-01-14,Cheese,45,45,55.0,0,0.01,0,270
2023-01-14,Vegetariana,195,199,55.0,0,0.02,4,1365
2023-01-14,Primavera,90,92,55.0,0,0.02,2,630
2023-01-14,Napolitana,60,61,55.0,0,0.02,1,420
2023-01-15,Pepperoni,75,77,54.5,0,0.03,2,450
2023-01-15,Cheese,90,91,54.5,0,0.01,1,540
2023-01-15,Vegetariana,165,173,54.5,0,0.05,8,1155
2023-01-15,Primavera,30,30,54.5,0,0.01,0,210
2023-01-15,Napolitana,15,15,54.5,0,0.02,0,105
2023-01-16,Pepperoni,45,46,59.0,0,0.02,1,270
2023-01-16,Cheese,75,76,59.0,0,0.01,1,450
2023-01-16,Vegetariana,105,109,59.0,0,0.04,4,735
2023-01-16,Primavera,60,61,59.0,0,0.01,1,420
2023-01-16,Napolitana,90,92,59.0,0,0.02,2,630
2023-01-17,Pepperoni,105,108,64.5,0,0.03,3,630
2023-01-17,Cheese,15,15,64.5,0,0.01,0,90
2023-01-17,Vegetariana,105,109,64.5,0,0.04,4,735
2023-01-17,Primavera,30,31,64.5,0,0.02,1,210
2023-01-17,Napolitana,45,46,64.5,0,0.02,1,315
2023-01-18,Pepperoni,60,61,69.0,0,0.02,1,360
2023-01-18,Cheese,15,15,69.0,0,0.02,0,90
2023-01-18,Vegetariana,165,170,69.0,0,0.03,5,1155
2023-01-18,Primavera,90,94,69.0,0,0.04,4,630
2023-01-18,Napolitana,15,15,69.0,0,0.03,0,105
2023-01-19,Pepperoni,90,91,73.5,0,0.01,1,540
2023-01-19,Cheese,15,15,73.5,0,0.01,0,90
2023-01-19,Vegetariana,120,122,73.5,0,0.02,2,840
2023-01-19,Primavera,45,46,73.5,0,0.03,1,315
2023-01-19,Napolitana,75,77,73.5,0,0.02,2,525
2023-01-20,Pepperoni,255,258,75.0,0,0.01,3,1530
2023-01-20,Cheese,90,91,75.0,0,0.01,1,540
2023-01-20,Vegetariana,255,260,75.0,0,0.02,5,1785
2023-01-20,Primavera,75,77,75.0,0,0.02,2,525
2023-01-20,Napolitana,120,122,75.0,0,0.02,2,840
2023-01-21,Pepperoni,75,76,75.0,0,0.01,1,450
2023-01-21,Cheese,135,136,75.0,0,0.01,1,810
2023-01-21,Vegetariana,195,199,75.0,0,0.02,4,1365
2023-01-21,Primavera,90,92,75.0,0,0.02,2,630
2023-01-21,Napolitana,90,92,75.0,0,0.02,2,630
2023-01-22,Pepperoni,90,93,77.5,0,0.03,3,540
2023-01-22,Cheese,90,91,77.5,0,0.01,1,540
2023-01-22,Vegetariana,75,79,77.5,0,0.05,4,525
2023-01-22,Primavera,90,91,77.5,0,0.01,1,630
2023-01-22,Napolitana,15,15,77.5,0,0.02,0,105
2023-01-23,Pepperoni,90,92,79.5,0,0.02,2,540
2023-01-23,Cheese,90,91,79.5,0,0.01,1,540
2023-01-23,Vegetariana,105,109,79.5,0,0.04,4,735
2023-01-23,Primavera,15,15,79.5,0,0.01,0,105
2023-01-23,Napolitana,60,61,79.5,0,0.02,1,420
2023-01-24,Pepperoni,90,93,74.5,0,0.03,3,540
2023-01-24,Cheese,15,15,74.5,0,0.01,0,90
2023-01-24,Vegetariana,105,109,74.5,0,0.04,4,735
2023-01-24,Primavera,75,77,74.5,0,0.02,2,525
2023-01-24,Napolitana,30,31,74.5,0,0.02,1,210
2023-01-25,Pepperoni,45,46,78.5,0,0.02,1,270
2023-01-25,Cheese,30,31,78.5,0,0.02,1,180
2023-01-25,Vegetariana,60,62,78.5,0,0.03,2,420
2023-01-25,Primavera,15,16,78.5,0,0.04,1,105
2023-01-25,Napolitana,15,15,78.5,0,0.03,0,105
2023-01-26,Pepperoni,120,121,75.5,0,0.01,1,720
2023-01-26,Cheese,75,76,75.5,0,0.01,1,450
2023-01-26,Vegetariana,180,184,75.5,0,0.02,4,1260
2023-01-26,Primavera,120,124,75.5,0,0.03,4,840
2023-01-26,Napolitana,30,31,75.5,0,0.02,1,210
2023-01-27,Pepperoni,225,227,66.5,0,0.01,2,1350
2023-01-27,Cheese,60,61,66.5,0,0.01,1,360
2023-01-27,Vegetariana,210,214,66.5,0,0.02,4,1470
2023-01-27,Primavera,210,214,66.5,0,0.02,4,1470
2023-01-27,Napolitana,75,77,66.5,0,0.02,2,525
2023-01-28,Pepperoni,285,288,71.5,0,0.01,3,1710
2023-01-28,Cheese,90,91,71.5,0,0.01,1,540
2023-01-28,Vegetariana,210,214,71.5,0,0.02,4,1470
2023-01-28,Primavera,180,184,71.5,0,0.02,4,1260
2023-01-28,Napolitana,135,138,71.5,0,0.02,3,945
2023-01-29,Pepperoni,165,170,77.5,0,0.03,5,990
2023-01-29,Cheese,75,76,77.5,0,0.01,1,450
2023-01-29,Vegetariana,120,126,77.5,0,0.05,6,840
2023-01-29,Primavera,15,15,77.5,0,0.01,0,105
2023-01-29,Napolitana,60,61,77.5,0,0.02,1,420
2023-01-30,Pepperoni,135,138,77.0,0,0.02,3,810
2023-01-30,Cheese,15,15,77.0,0,0.01,0,90
2023-01-30,Vegetariana,45,47,77.0,0,0.04,2,315
2023-01-30,Primavera,105,106,77.0,0,0.01,1,735
2023-01-30,Napolitana,45,46,77.0,0,0.02,1,315
2023-01-31,Pepperoni,15,15,78.0,0,0.03,0,90
2023-01-31,Cheese,45,45,78.0,0,0.01,0,270
2023-01-31,Vegetariana,135,140,78.0,0,0.04,5,945
2023-01-31,Primavera,60,61,78.0,0,0.02,1,420
2023-01-31,Napolitana,15,15,78.0,0,0.02,0,105
2023-02-01,Pepperoni,15,15,77.0,0,0.02,0,90
2023-02-01,Cheese,15,15,77.0,0,0.02,0,90
2023-02-01,Vegetariana,75,77,77.0,0,0.03,2,525
2023-02-01,Primavera,75,78,77.0,0,0.04,3,525
2023-02-01,Napolitana,30,31,77.0,0,0.03,1,210
2023-02-02,Pepperoni,90,91,77.0,0,0.01,1,540
2023-02-02,Cheese,60,61,77.0,0,0.01,1,360
2023-02-02,Vegetariana,135,138,77.0,0,0.02,3,945
2023-02-02,Primavera,195,201,77.0,0,0.03,6,1365
2023-02-02,Napolitana,45,46,77.0,0,0.02,1,315
2023-02-03,Pepperoni,135,136,78.5,0,0.01,1,810
2023-02-03,Cheese,225,227,78.5,0,0.01,2,1350
2023-02-03,Vegetariana,255,260,78.5,0,0.02,5,1785
2023-02-03,Primavera,90,92,78.5,0,0.02,2,630
2023-02-03,Napolitana,135,138,78.5,0,0.02,3,945
2023-02-04,Pepperoni,210,212,69.5,1,0.01,2,1260
2023-02-04,Cheese,105,106,69.5,1,0.01,1,630
2023-02-04,Vegetariana,255,260,69.5,1,0.02,5,1785
2023-02-04,Primavera,210,214,69.5,1,0.02,4,1470
2023-02-04,Napolitana,75,77,69.5,1,0.02,2,525
2023-02-05,Pepperoni,90,93,75.5,1,0.03,3,540
2023-02-05,Cheese,30,30,75.5,1,0.01,0,180
2023-02-05,Vegetariana,75,79,75.5,1,0.05,4,525
2023-02-05,Primavera,75,76,75.5,1,0.01,1,525
2023-02-05,Napolitana,30,31,75.5,1,0.02,1,210
2023-02-06,Pepperoni,45,46,75.0,0,0.02,1,270
2023-02-06,Cheese,150,152,75.0,0,0.01,2,900
2023-02-06,Vegetariana,75,78,75.0,0,0.04,3,525
2023-02-06,Primavera,120,121,75.0,0,0.01,1,840
2023-02-06,Napolitana,15,15,75.0,0,0.02,0,105
2023-02-07,Pepperoni,135,139,74.5,0,0.03,4,810
2023-02-07,Cheese,75,76,74.5,0,0.01,1,450
2023-02-07,Vegetariana,60,62,74.5,0,0.04,2,420
2023-02-07,Primavera,120,122,74.5,0,0.02,2,840
2023-02-07,Napolitana,120,122,74.5,0,0.02,2,840
2023-02-08,Pepperoni,135,138,75.5,0,0.02,3,810
2023-02-08,Cheese,30,31,75.5,0,0.02,1,180
2023-02-08,Vegetariana,150,155,75.5,0,0.03,5,1050
2023-02-08,Primavera,30,31,75.5,0,0.04,1,210
2023-02-08,Napolitana,60,62,75.5,0,0.03,2,420
2023-02-09,Pepperoni,75,76,77.5,0,0.01,1,450
2023-02-09,Cheese,60,61,77.5,0,0.01,1,360
2023-02-09,Vegetariana,180,184,77.5,0,0.02,4,1260
2023-02-09,Primavera,165,170,77.5,0,0.03,5,1155
2023-02-09,Napolitana,15,15,77.5,0,0.02,0,105
2023-02-10,Pepperoni,180,182,78.0,0,0.01,2,1080
2023-02-10,Cheese,15,15,78.0,0,0.01,0,90
2023-02-10,Vegetariana,180,184,78.0,0,0.02,4,1260
2023-02-10,Primavera,135,138,78.0,0,0.02,3,945
2023-02-10,Napolitana,75,77,78.0,0,0.02,2,525
2023-02-11,Pepperoni,165,167,79.0,0,0.01,2,990
2023-02-11,Cheese,90,91,79.0,0,0.01,1,540
2023-02-11,Vegetariana,135,138,79.0,0,0.02,3,945
2023-02-11,Primavera,165,168,79.0,0,0.02,3,1155
2023-02-11,Napolitana,75,77,79.0,0,0.02,2,525
2023-02-12,Pepperoni,75,77,71.5,1,0.03,2,450
2023-02-12,Cheese,45,45,71.5,1,0.01,0,270
2023-02-12,Vegetariana,75,79,71.5,1,0.05,4,525
2023-02-12,Primavera,15,15,71.5,1,0.01,0,105
2023-02-12,Napolitana,30,31,71.5,1,0.02,1,210
2023-02-13,Pepperoni,90,92,67.0,0,0.02,2,540
2023-02-13,Cheese,15,15,67.0,0,0.01,0,90
2023-02-13,Vegetariana,135,140,67.0,0,0.04,5,945
2023-02-13,Primavera,60,61,67.0,0,0.01,1,420
2023-02-13,Napolitana,90,92,67.0,0,0.02,2,630
2023-02-14,Pepperoni,90,93,67.0,0,0.03,3,540
2023-02-14,Cheese,15,15,67.0,0,0.01,0,90
2023-02-14,Vegetariana,210,218,67.0,0,0.04,8,1470
2023-02-14,Primavera,75,77,67.0,0,0.02,2,525
2023-02-14,Napolitana,75,77,67.0,0,0.02,2,525
2023-02-15,Pepperoni,75,77,76.0,0,0.02,2,450
2023-02-15,Cheese,30,31,76.0,0,0.02,1,180
2023-02-15,Vegetariana,60,62,76.0,0,0.03,2,420
2023-02-15,Primavera,15,16,76.0,0,0.04,1,105
2023-02-15,Napolitana,45,46,76.0,0,0.03,1,315
2023-02-16,Pepperoni,30,30,78.0,0,0.01,0,180
2023-02-16,Cheese,135,136,78.0,0,0.01,1,810
2023-02-16,Vegetariana,150,153,78.0,0,0.02,3,1050
2023-02-16,Primavera,75,77,78.0,0,0.03,2,525
2023-02-16,Napolitana,30,31,78.0,0,0.02,1,210
2023-02-17,Pepperoni,165,167,77.0,1,0.01,2,990
2023-02-17,Cheese,60,61,77.0,1,0.01,1,360
2023-02-17,Vegetariana,300,306,77.0,1,0.02,6,2100
2023-02-17,Primavera,90,92,77.0,1,0.02,2,630
2023-02-17,Napolitana,75,77,77.0,1,0.02,2,525
2023-02-18,Pepperoni,165,167,76.5,0,0.01,2,990
2023-02-18,Cheese,120,121,76.5,0,0.01,1,720
2023-02-18,Vegetariana,315,321,76.5,0,0.02,6,2205
2023-02-18,Primavera,105,107,76.5,0,0.02,2,735
2023-02-18,Napolitana,180,184,76.5,0,0.02,4,1260
2023-02-19,Pepperoni,105,108,77.5,0,0.03,3,630
2023-02-19,Cheese,45,45,77.5,0,0.01,0,270
2023-02-19,Vegetariana,60,63,77.5,0,0.05,3,420
2023-02-19,Primavera,75,76,77.5,0,0.01,1,525
2023-02-19,Napolitana,15,15,77.5,0,0.02,0,105
2023-02-20,Pepperoni,60,61,78.5,0,0.02,1,360
2023-02-20,Cheese,60,61,78.5,0,0.01,1,360
2023-02-20,Vegetariana,75,78,78.5,0,0.04,3,525
2023-02-20,Primavera,30,30,78.5,0,0.01,0,210
2023-02-20,Napolitana,30,31,78.5,0,0.02,1,210
2023-02-21,Pepperoni,45,46,78.0,0,0.03,1,270
2023-02-21,Cheese,15,15,78.0,0,0.01,0,90
2023-02-21,Vegetariana,90,94,78.0,0,0.04,4,630
2023-02-21,Primavera,30,31,78.0,0,0.02,1,210
2023-02-21,Napolitana,60,61,78.0,0,0.02,1,420
2023-02-22,Pepperoni,75,77,76.5,0,0.02,2,450
2023-02-22,Cheese,30,31,76.5,0,0.02,1,180
2023-02-22,Vegetariana,90,93,76.5,0,0.03,3,630
2023-02-22,Primavera,60,62,76.5,0,0.04,2,420
2023-02-22,Napolitana,30,31,76.5,0,0.03,1,210
2023-02-23,Pepperoni,60,61,79.5,0,0.01,1,360
2023-02-23,Cheese,60,61,79.5,0,0.01,1,360
2023-02-23,Vegetariana,150,153,79.5,0,0.02,3,1050
2023-02-23,Primavera,90,93,79.5,0,0.03,3,630
2023-02-23,Napolitana,60,61,79.5,0,0.02,1,420
2023-02-24,Pepperoni,180,182,78.0,0,0.01,2,1080
2023-02-24,Cheese,180,182,78.0,0,0.01,2,1080
2023-02-24,Vegetariana,225,230,78.0,0,0.02,5,1575
2023-02-24,Primavera,195,199,78.0,0,0.02,4,1365
2023-02-24,Napolitana,60,61,78.0,0,0.02,1,420
2023-02-25,Pepperoni,300,303,76.5,0,0.01,3,1800
2023-02-25,Cheese,105,106,76.5,0,0.01,1,630
2023-02-25,Vegetariana,240,245,76.5,0,0.02,5,1680
2023-02-25,Primavera,210,214,76.5,0,0.02,4,1470
2023-02-25,Napolitana,15,15,76.5,0,0.02,0,105
2023-02-26,Pepperoni,75,77,78.0,0,0.03,2,450
2023-02-26,Cheese,75,76,78.0,0,0.01,1,450
2023-02-26,Vegetariana,195,205,78.0,0,0.05,10,1365
2023-02-26,Primavera,45,45,78.0,0,0.01,0,315
2023-02-26,Napolitana,75,77,78.0,0,0.02,2,525
2023-02-27,Pepperoni,60,61,75.5,0,0.02,1,360
2023-02-27,Cheese,90,91,75.5,0,0.01,1,540
2023-02-27,Vegetariana,165,172,75.5,0,0.04,7,1155
2023-02-27,Primavera,75,76,75.5,0,0.01,1,525
2023-02-27,Napolitana,30,31,75.5,0,0.02,1,210
2023-02-28,Pepperoni,60,62,76.0,0,0.03,2,360
2023-02-28,Cheese,45,45,76.0,0,0.01,0,270
2023-02-28,Vegetariana,60,62,76.0,0,0.04,2,420
2023-02-28,Primavera,45,46,76.0,0,0.02,1,315
2023-02-28,Napolitana,75,77,76.0,0,0.02,2,525
2023-03-01,Pepperoni,105,107,73.5,0,0.02,2,630
2023-03-01,Cheese,15,15,73.5,0,0.02,0,90
2023-03-01,Vegetariana,180,185,73.5,0,0.03,5,1260
2023-03-01,Primavera,90,94,73.5,0,0.04,4,630
2023-03-01,Napolitana,30,31,73.5,0,0.03,1,210
2023-03-02,Pepperoni,75,76,77.0,0,0.01,1,450
2023-03-02,Cheese,60,61,77.0,0,0.01,1,360
2023-03-02,Vegetariana,105,107,77.0,0,0.02,2,735
2023-03-02,Primavera,195,201,77.0,0,0.03,6,1365
2023-03-02,Napolitana,45,46,77.0,0,0.02,1,315
2023-03-03,Pepperoni,165,167,81.0,0,0.01,2,990
2023-03-03,Cheese,165,167,81.0,0,0.01,2,990
2023-03-03,Vegetariana,225,230,81.0,0,0.02,5,1575
2023-03-03,Primavera,60,61,81.0,0,0.02,1,420
2023-03-03,Napolitana,180,184,81.0,0,0.02,4,1260
2023-03-04,Pepperoni,240,242,80.0,0,0.01,2,1440
2023-03-04,Cheese,90,91,80.0,0,0.01,1,540
2023-03-04,Vegetariana,210,214,80.0,0,0.02,4,1470
2023-03-04,Primavera,165,168,80.0,0,0.02,3,1155
2023-03-04,Napolitana,75,77,80.0,0,0.02,2,525
2023-03-05,Pepperoni,75,77,78.5,0,0.03,2,450
2023-03-05,Cheese,45,45,78.5,0,0.01,0,270
2023-03-05,Vegetariana,165,173,78.5,0,0.05,8,1155
2023-03-05,Primavera,30,30,78.5,0,0.01,0,210
2023-03-05,Napolitana,75,77,78.5,0,0.02,2,525
2023-03-06,Pepperoni,120,122,81.5,0,0.02,2,720
2023-03-06,Cheese,75,76,81.5,0,0.01,1,450
2023-03-06,Vegetariana,180,187,81.5,0,0.04,7,1260
2023-03-06,Primavera,60,61,81.5,0,0.01,1,420
2023-03-06,Napolitana,45,46,81.5,0,0.02,1,315
2023-03-07,Pepperoni,45,46,81.0,1,0.03,1,270
2023-03-07,Cheese,15,15,81.0,1,0.01,0,90
2023-03-07,Vegetariana,30,31,81.0,1,0.04,1,210
2023-03-07,Primavera,30,31,81.0,1,0.02,1,210
2023-03-07,Napolitana,15,15,81.0,1,0.02,0,105
2023-03-08,Pepperoni,120,122,82.0,1,0.02,2,720
2023-03-08,Cheese,45,46,82.0,1,0.02,1,270
2023-03-08,Vegetariana,45,46,82.0,1,0.03,1,315
2023-03-08,Primavera,45,47,82.0,1,0.04,2,315
2023-03-08,Napolitana,75,77,82.0,1,0.03,2,525
2023-03-09,Pepperoni,45,45,76.0,1,0.01,0,270
2023-03-09,Cheese,45,45,76.0,1,0.01,0,270
2023-03-09,Vegetariana,135,138,76.0,1,0.02,3,945
2023-03-09,Primavera,90,93,76.0,1,0.03,3,630
2023-03-09,Napolitana,90,92,76.0,1,0.02,2,630
2023-03-10,Pepperoni,165,167,74.0,0,0.01,2,990
2023-03-10,Cheese,135,136,74.0,0,0.01,1,810
2023-03-10,Vegetariana,255,260,74.0,0,0.02,5,1785
2023-03-10,Primavera,120,122,74.0,0,0.02,2,840
2023-03-10,Napolitana,150,153,74.0,0,0.02,3,1050
2023-03-11,Pepperoni,555,561,77.5,0,0.01,6,3330
2023-03-11,Cheese,45,45,77.5,0,0.01,0,270
2023-03-11,Vegetariana,165,168,77.5,0,0.02,3,1155
2023-03-11,Primavera,195,199,77.5,0,0.02,4,1365
2023-03-11,Napolitana,105,107,77.5,0,0.02,2,735
2023-03-12,Pepperoni,45,46,77.5,0,0.03,1,270
2023-03-12,Cheese,60,61,77.5,0,0.01,1,360
2023-03-12,Vegetariana,150,158,77.5,0,0.05,8,1050
2023-03-12,Primavera,15,15,77.5,0,0.01,0,105
2023-03-12,Napolitana,15,15,77.5,0,0.02,0,105
2023-03-13,Pepperoni,195,199,80.5,0,0.02,4,1170
2023-03-13,Cheese,15,15,80.5,0,0.01,0,90
2023-03-13,Vegetariana,150,156,80.5,0,0.04,6,1050
2023-03-13,Primavera,105,106,80.5,0,0.01,1,735
2023-03-13,Napolitana,60,61,80.5,0,0.02,1,420
2023-03-14,Pepperoni,75,77,78.0,0,0.03,2,450
2023-03-14,Cheese,15,15,78.0,0,0.01,0,90
2023-03-14,Vegetariana,300,312,78.0,0,0.04,12,2100
2023-03-14,Primavera,45,46,78.0,0,0.02,1,315
2023-03-14,Napolitana,90,92,78.0,0,0.02,2,630
2023-03-15,Pepperoni,135,138,70.5,1,0.02,3,810
2023-03-15,Cheese,15,15,70.5,1,0.02,0,90
2023-03-15,Vegetariana,120,124,70.5,1,0.03,4,840
2023-03-15,Primavera,135,140,70.5,1,0.04,5,945
2023-03-15,Napolitana,90,93,70.5,1,0.03,3,630
2023-03-16,Pepperoni,150,152,68.0,0,0.01,2,900
2023-03-16,Cheese,105,106,68.0,0,0.01,1,630
2023-03-16,Vegetariana,435,444,68.0,0,0.02,9,3045
2023-03-16,Primavera,15,15,68.0,0,0.03,0,105
2023-03-16,Napolitana,45,46,68.0,0,0.02,1,315
2023-03-17,Pepperoni,330,333,74.5,0,0.01,3,1980
2023-03-17,Cheese,75,76,74.5,0,0.01,1,450
2023-03-17,Vegetariana,600,612,74.5,0,0.02,12,4200
2023-03-17,Primavera,315,321,74.5,0,0.02,6,2205
2023-03-17,Napolitana,390,398,74.5,0,0.02,8,2730
2023-03-18,Pepperoni,450,455,78.0,0,0.01,5,2700
2023-03-18,Cheese,105,106,78.0,0,0.01,1,630
2023-03-18,Vegetariana,465,474,78.0,0,0.02,9,3255
2023-03-18,Primavera,240,245,78.0,0,0.02,5,1680
2023-03-18,Napolitana,240,245,78.0,0,0.02,5,1680
2023-03-19,Pepperoni,210,216,70.5,1,0.03,6,1260
2023-03-19,Cheese,45,45,70.5,1,0.01,0,270
2023-03-19,Vegetariana,240,252,70.5,1,0.05,12,1680
2023-03-19,Primavera,120,121,70.5,1,0.01,1,840
2023-03-19,Napolitana,15,15,70.5,1,0.02,0,105
2023-03-20,Pepperoni,135,138,68.0,1,0.02,3,810
2023-03-20,Cheese,90,91,68.0,1,0.01,1,540
2023-03-20,Vegetariana,180,187,68.0,1,0.04,7,1260
2023-03-20,Primavera,45,45,68.0,1,0.01,0,315
2023-03-20,Napolitana,30,31,68.0,1,0.02,1,210
2023-03-21,Pepperoni,45,46,71.0,0,0.03,1,270
2023-03-21,Cheese,90,91,71.0,0,0.01,1,540
2023-03-21,Vegetariana,180,187,71.0,0,0.04,7,1260
2023-03-21,Primavera,105,107,71.0,0,0.02,2,735
2023-03-21,Napolitana,15,15,71.0,0,0.02,0,105
2023-03-22,Pepperoni,45,46,74.0,0,0.02,1,270
2023-03-22,Cheese,75,77,74.0,0,0.02,2,450
2023-03-22,Vegetariana,255,263,74.0,0,0.03,8,1785
2023-03-22,Primavera,30,31,74.0,0,0.04,1,210
2023-03-22,Napolitana,90,93,74.0,0,0.03,3,630
2023-03-23,Pepperoni,150,152,78.0,1,0.01,2,900
2023-03-23,Cheese,135,136,78.0,1,0.01,1,810
2023-03-23,Vegetariana,135,138,78.0,1,0.02,3,945
2023-03-23,Primavera,75,77,78.0,1,0.03,2,525
2023-03-23,Napolitana,60,61,78.0,1,0.02,1,420
2023-03-24,Pepperoni,255,258,77.5,0,0.01,3,1530
2023-03-24,Cheese,90,91,77.5,0,0.01,1,540
2023-03-24,Vegetariana,465,474,77.5,0,0.02,9,3255
2023-03-24,Primavera,165,168,77.5,0,0.02,3,1155
2023-03-24,Napolitana,135,138,77.5,0,0.02,3,945
2023-03-25,Pepperoni,255,258,80.0,0,0.01,3,1530
2023-03-25,Cheese,150,152,80.0,0,0.01,2,900
2023-03-25,Vegetariana,210,214,80.0,0,0.02,4,1470
2023-03-25,Primavera,120,122,80.0,0,0.02,2,840
2023-03-25,Napolitana,165,168,80.0,0,0.02,3,1155
2023-03-26,Pepperoni,60,62,80.5,0,0.03,2,360
2023-03-26,Cheese,45,45,80.5,0,0.01,0,270
2023-03-26,Vegetariana,30,32,80.5,0,0.05,2,210
2023-03-26,Primavera,15,15,80.5,0,0.01,0,105
2023-03-26,Napolitana,60,61,80.5,0,0.02,1,420
2023-03-27,Pepperoni,120,122,81.0,0,0.02,2,720
2023-03-27,Cheese,60,61,81.0,0,0.01,1,360
2023-03-27,Vegetariana,105,109,81.0,0,0.04,4,735
2023-03-27,Primavera,15,15,81.0,0,0.01,0,105
2023-03-27,Napolitana,75,77,81.0,0,0.02,2,525
2023-03-28,Pepperoni,135,139,81.0,1,0.03,4,810
2023-03-28,Cheese,45,45,81.0,1,0.01,0,270
2023-03-28,Vegetariana,120,125,81.0,1,0.04,5,840
2023-03-28,Primavera,30,31,81.0,1,0.02,1,210
2023-03-28,Napolitana,75,77,81.0,1,0.02,2,525
2023-03-29,Pepperoni,105,107,78.0,1,0.02,2,630
2023-03-29,Cheese,45,46,78.0,1,0.02,1,270
2023-03-29,Vegetariana,60,62,78.0,1,0.03,2,420
2023-03-29,Primavera,90,94,78.0,1,0.04,4,630
2023-03-29,Napolitana,60,62,78.0,1,0.03,2,420
2023-03-30,Pepperoni,240,242,75.0,1,0.01,2,1440
2023-03-30,Cheese,105,106,75.0,1,0.01,1,630
2023-03-30,Vegetariana,255,260,75.0,1,0.02,5,1785
2023-03-30,Primavera,210,216,75.0,1,0.03,6,1470
2023-03-30,Napolitana,165,168,75.0,1,0.02,3,1155
2023-03-31,Pepperoni,195,197,78.0,0,0.01,2,1170
2023-03-31,Cheese,75,76,78.0,0,0.01,1,450
2023-03-31,Vegetariana,270,275,78.0,0,0.02,5,1890
2023-03-31,Primavera,180,184,78.0,0,0.02,4,1260
2023-03-31,Napolitana,285,291,78.0,0,0.02,6,1995
2023-04-01,Pepperoni,285,288,79.5,1,0.01,3,1710
2023-04-01,Cheese,150,152,79.5,1,0.01,2,900
2023-04-01,Vegetariana,195,199,79.5,1,0.02,4,1365
2023-04-01,Primavera,165,168,79.5,1,0.02,3,1155
2023-04-01,Napolitana,90,92,79.5,1,0.02,2,630
2023-04-02,Pepperoni,240,247,81.0,0,0.03,7,1440
2023-04-02,Cheese,75,76,81.0,0,0.01,1,450
2023-04-02,Vegetariana,150,158,81.0,0,0.05,8,1050
2023-04-02,Primavera,45,45,81.0,0,0.01,0,315
2023-04-02,Napolitana,30,31,81.0,0,0.02,1,210
2023-04-03,Pepperoni,120,122,79.5,0,0.02,2,720
2023-04-03,Cheese,90,91,79.5,0,0.01,1,540
2023-04-03,Vegetariana,60,62,79.5,0,0.04,2,420
2023-04-03,Primavera,15,15,79.5,0,0.01,0,105
2023-04-03,Napolitana,90,92,79.5,0,0.02,2,630
2023-04-04,Pepperoni,105,108,81.0,0,0.03,3,630
2023-04-04,Cheese,45,45,81.0,0,0.01,0,270
2023-04-04,Vegetariana,120,125,81.0,0,0.04,5,840
2023-04-04,Primavera,30,31,81.0,0,0.02,1,210
2023-04-04,Napolitana,30,31,81.0,0,0.02,1,210
2023-04-05,Pepperoni,30,31,82.0,1,0.02,1,180
2023-04-05,Cheese,30,31,82.0,1,0.02,1,180
2023-04-05,Vegetariana,210,216,82.0,1,0.03,6,1470
2023-04-05,Primavera,60,62,82.0,1,0.04,2,420
2023-04-05,Napolitana,30,31,82.0,1,0.03,1,210
2023-04-06,Pepperoni,180,182,82.0,1,0.01,2,1080
2023-04-06,Cheese,75,76,82.0,1,0.01,1,450
2023-04-06,Vegetariana,165,168,82.0,1,0.02,3,1155
2023-04-06,Primavera,135,139,82.0,1,0.03,4,945
2023-04-06,Napolitana,60,61,81.0,1,0.02,1,420
2023-04-07,Pepperoni,255,258,81.0,0,0.01,3,1530
2023-04-07,Cheese,150,152,81.0,0,0.01,2,900
2023-04-07,Vegetariana,195,199,81.0,0,0.02,4,1365
2023-04-07,Primavera,270,275,81.0,0,0.02,5,1890
2023-04-07,Napolitana,150,153,81.0,0,0.02,3,1050
2023-04-08,Pepperoni,255,258,80.5,1,0.01,3,1530
2023-04-08,Cheese,105,106,80.5,1,0.01,1,630
2023-04-08,Vegetariana,135,138,80.5,1,0.02,3,945
2023-04-08,Primavera,195,199,80.5,1,0.02,4,1365
2023-04-08,Napolitana,135,138,80.5,1,0.02,3,945
2023-04-09,Pepperoni,45,46,80.0,1,0.03,1,270
2023-04-09,Cheese,90,91,80.0,1,0.01,1,540
2023-04-09,Vegetariana,120,126,80.0,1,0.05,6,840
2023-04-09,Primavera,45,45,80.0,1,0.01,0,315
2023-04-09,Napolitana,60,61,80.0,1,0.02,1,420
2023-04-10,Pepperoni,45,46,75.0,1,0.02,1,270
2023-04-10,Cheese,15,15,75.0,1,0.01,0,90
2023-04-10,Vegetariana,75,78,75.0,1,0.04,3,525
2023-04-10,Primavera,30,30,75.0,1,0.01,0,210
2023-04-10,Napolitana,15,15,75.0,1,0.02,0,105
2023-04-11,Pepperoni,75,77,72.5,1,0.03,2,450
2023-04-11,Cheese,60,61,72.5,1,0.01,1,360
2023-04-11,Vegetariana,30,31,72.5,1,0.04,1,210
2023-04-11,Primavera,45,46,72.5,1,0.02,1,315
2023-04-11,Napolitana,90,92,72.5,1,0.02,2,630
2023-04-12,Pepperoni,105,107,72.5,1,0.02,2,630
2023-04-12,Cheese,45,46,72.5,1,0.02,1,270
2023-04-12,Vegetariana,60,62,72.5,1,0.03,2,420
2023-04-12,Primavera,30,31,72.5,1,0.04,1,210
2023-04-12,Napolitana,105,108,72.5,1,0.03,3,735
2023-04-13,Pepperoni,75,76,80.0,0,0.01,1,450
2023-04-13,Cheese,60,61,80.0,0,0.01,1,360
2023-04-13,Vegetariana,150,153,80.0,0,0.02,3,1050
2023-04-13,Primavera,75,77,80.0,0,0.03,2,525
2023-04-13,Napolitana,75,77,80.0,0,0.02,2,525
2023-04-14,Pepperoni,180,182,81.0,1,0.01,2,1080
2023-04-14,Cheese,45,45,81.0,1,0.01,0,270
2023-04-14,Vegetariana,180,184,81.0,1,0.02,4,1260
2023-04-14,Primavera,120,122,81.0,1,0.02,2,840
2023-04-14,Napolitana,60,61,81.0,1,0.02,1,420
2023-04-15,Pepperoni,240,242,82.0,0,0.01,2,1440
2023-04-15,Cheese,90,91,82.0,0,0.01,1,540
2023-04-15,Vegetariana,135,138,82.0,0,0.02,3,945
2023-04-15,Primavera,105,107,82.0,0,0.02,2,735
2023-04-15,Napolitana,90,92,82.0,0,0.02,2,630
2023-04-16,Pepperoni,165,170,80.5,1,0.03,5,990
2023-04-16,Cheese,45,45,80.5,1,0.01,0,270
2023-04-16,Vegetariana,180,189,80.5,1,0.05,9,1260
2023-04-16,Primavera,90,91,80.5,1,0.01,1,630
2023-04-16,Napolitana,75,77,80.5,1,0.02,2,525
2023-04-17,Pepperoni,150,153,79.0,1,0.02,3,900
2023-04-17,Cheese,15,15,79.0,1,0.01,0,90
2023-04-17,Vegetariana,120,125,79.0,1,0.04,5,840
2023-04-17,Primavera,60,61,79.0,1,0.01,1,420
2023-04-17,Napolitana,45,46,79.0,1,0.02,1,315
2023-04-18,Pepperoni,45,46,76.0,0,0.03,1,270
2023-04-18,Cheese,105,106,76.0,0,0.01,1,630
2023-04-18,Vegetariana,90,94,76.0,0,0.04,4,630
2023-04-18,Primavera,30,31,76.0,0,0.02,1,210
2023-04-18,Napolitana,30,31,76.0,0,0.02,1,210
2023-04-19,Pepperoni,135,138,76.5,0,0.02,3,810
2023-04-19,Cheese,45,46,76.5,0,0.02,1,270
2023-04-19,Vegetariana,60,62,76.5,0,0.03,2,420
2023-04-19,Primavera,45,47,76.5,0,0.04,2,315
2023-04-19,Napolitana,30,31,76.5,0,0.03,1,210
2023-04-20,Pepperoni,150,152,77.5,0,0.01,2,900
2023-04-20,Cheese,90,91,77.5,0,0.01,1,540
2023-04-20,Vegetariana,135,138,77.5,0,0.02,3,945
2023-04-20,Primavera,30,31,77.5,0,0.03,1,210
2023-04-20,Napolitana,45,46,77.5,0,0.02,1,315
2023-04-21,Pepperoni,195,197,78.5,1,0.01,2,1170
2023-04-21,Cheese,90,91,78.5,1,0.01,1,540
2023-04-21,Vegetariana,165,168,78.5,1,0.02,3,1155
2023-04-21,Primavera,45,46,78.5,1,0.02,1,315
2023-04-21,Napolitana,30,31,78.5,1,0.02,1,210
2023-04-22,Pepperoni,150,152,80.5,1,0.01,2,900
2023-04-22,Cheese,120,121,80.5,1,0.01,1,720
2023-04-22,Vegetariana,270,275,80.5,1,0.02,5,1890
2023-04-22,Primavera,105,107,80.5,1,0.02,2,735
2023-04-22,Napolitana,120,122,80.5,1,0.02,2,840
2023-04-23,Pepperoni,75,77,80.0,0,0.03,2,450
2023-04-23,Cheese,30,30,80.0,0,0.01,0,180
2023-04-23,Vegetariana,45,47,80.0,0,0.05,2,315
2023-04-23,Primavera,90,91,80.0,0,0.01,1,630
2023-04-23,Napolitana,15,15,80.0,0,0.02,0,105
2023-04-24,Pepperoni,30,31,78.0,1,0.02,1,180
2023-04-24,Cheese,60,61,78.0,1,0.01,1,360
2023-04-24,Vegetariana,45,47,78.0,1,0.04,2,315
2023-04-24,Primavera,60,61,78.0,1,0.01,1,420
2023-04-24,Napolitana,15,15,78.0,1,0.02,0,105
2023-04-25,Pepperoni,30,31,78.0,1,0.03,1,180
2023-04-25,Cheese,75,76,78.0,1,0.01,1,450
2023-04-25,Vegetariana,105,109,78.0,1,0.04,4,735
2023-04-25,Primavera,45,46,78.0,1,0.02,1,315
2023-04-25,Napolitana,45,46,78.0,1,0.02,1,315
2023-04-26,Pepperoni,135,138,80.0,1,0.02,3,810
2023-04-26,Cheese,30,31,80.0,1,0.02,1,180
2023-04-26,Vegetariana,45,46,80.0,1,0.03,1,315
2023-04-26,Primavera,15,16,80.0,1,0.04,1,105
2023-04-26,Napolitana,75,77,80.0,1,0.03,2,525
2023-04-27,Pepperoni,75,76,81.0,0,0.01,1,450
2023-04-27,Cheese,60,61,81.0,0,0.01,1,360
2023-04-27,Vegetariana,195,199,81.0,0,0.02,4,1365
2023-04-27,Primavera,45,46,81.0,0,0.03,1,315
2023-04-27,Napolitana,90,92,81.0,0,0.02,2,630
2023-04-28,Pepperoni,180,182,81.5,0,0.01,2,1080
2023-04-28,Cheese,90,91,81.5,0,0.01,1,540
2023-04-28,Vegetariana,105,107,81.5,0,0.02,2,735
2023-04-28,Primavera,195,199,81.5,0,0.02,4,1365
2023-04-28,Napolitana,75,77,81.5,0,0.02,2,525
2023-04-29,Pepperoni,165,167,84.5,1,0.01,2,990
2023-04-29,Cheese,75,76,84.5,1,0.01,1,450
2023-04-29,Vegetariana,195,199,84.5,1,0.02,4,1365
2023-04-29,Primavera,150,153,84.5,1,0.02,3,1050
2023-04-29,Napolitana,135,138,84.5,1,0.02,3,945
2023-04-30,Pepperoni,120,124,79.5,1,0.03,4,720
2023-04-30,Cheese,30,30,79.5,1,0.01,0,180
2023-04-30,Vegetariana,75,79,79.5,1,0.05,4,525
2023-04-30,Primavera,60,61,79.5,1,0.01,1,420
2023-04-30,Napolitana,15,15,79.5,1,0.02,0,105
2023-05-01,Pepperoni,60,61,78.5,0,0.02,1,360
2023-05-01,Cheese,15,15,78.5,0,0.01,0,90
2023-05-01,Vegetariana,120,125,78.5,0,0.04,5,840
2023-05-01,Primavera,60,61,78.5,0,0.01,1,420
2023-05-01,Napolitana,60,61,78.5,0,0.02,1,420
2023-05-02,Pepperoni,15,15,80.5,0,0.03,0,90
2023-05-02,Cheese,30,30,80.5,0,0.01,0,180
2023-05-02,Vegetariana,60,62,80.5,0,0.04,2,420
2023-05-02,Primavera,45,46,80.5,0,0.02,1,315
2023-05-02,Napolitana,60,61,80.5,0,0.02,1,420
2023-05-03,Pepperoni,135,138,81.0,0,0.02,3,810
2023-05-03,Cheese,30,31,81.0,0,0.02,1,180
2023-05-03,Vegetariana,60,62,81.0,0,0.03,2,420
2023-05-03,Primavera,90,94,81.0,0,0.04,4,630
2023-05-03,Napolitana,75,77,81.0,0,0.03,2,525
2023-05-04,Pepperoni,60,61,78.5,0,0.01,1,360
2023-05-04,Cheese,45,45,78.5,0,0.01,0,270
2023-05-04,Vegetariana,90,92,78.5,0,0.02,2,630
2023-05-04,Primavera,105,108,78.5,0,0.03,3,735
2023-05-04,Napolitana,45,46,78.5,0,0.02,1,315
2023-05-05,Pepperoni,210,212,79.0,0,0.01,2,1260
2023-05-05,Cheese,105,106,79.0,0,0.01,1,630
2023-05-05,Vegetariana,375,383,79.0,0,0.02,8,2625
2023-05-05,Primavera,105,107,79.0,0,0.02,2,735
2023-05-05,Napolitana,165,168,79.0,0,0.02,3,1155
2023-05-06,Pepperoni,75,76,81.0,1,0.01,1,450
2023-05-06,Cheese,15,15,81.0,1,0.01,0,90
2023-05-06,Vegetariana,180,184,81.0,1,0.02,4,1260
2023-05-06,Primavera,75,77,81.0,1,0.02,2,525
2023-05-06,Napolitana,90,92,81.0,1,0.02,2,630
2023-05-07,Pepperoni,195,201,79.0,1,0.03,6,1170
2023-05-07,Cheese,45,45,79.0,1,0.01,0,270
2023-05-07,Vegetariana,90,95,79.0,1,0.05,5,630
2023-05-07,Primavera,15,15,79.0,1,0.01,0,105
2023-05-07,Napolitana,90,92,79.0,1,0.02,2,630
2023-05-08,Pepperoni,135,138,79.0,0,0.02,3,810
2023-05-08,Cheese,75,76,79.0,0,0.01,1,450
2023-05-08,Vegetariana,90,94,79.0,0,0.04,4,630
2023-05-08,Primavera,45,45,79.0,0,0.01,0,315
2023-05-08,Napolitana,45,46,79.0,0,0.02,1,315
2023-05-09,Pepperoni,90,93,80.0,0,0.03,3,540
2023-05-09,Cheese,15,15,80.0,0,0.01,0,90
2023-05-09,Vegetariana,105,109,80.0,0,0.04,4,735
2023-05-09,Primavera,60,61,80.0,0,0.02,1,420
2023-05-09,Napolitana,45,46,80.0,0,0.02,1,315
2023-05-10,Pepperoni,105,107,83.0,0,0.02,2,630
2023-05-10,Cheese,45,46,83.0,0,0.02,1,270
2023-05-10,Vegetariana,135,139,83.0,0,0.03,4,945
2023-05-10,Primavera,75,78,83.0,0,0.04,3,525
2023-05-10,Napolitana,45,46,83.0,0,0.03,1,315
2023-05-11,Pepperoni,180,182,82.0,0,0.01,2,1080
2023-05-11,Cheese,45,45,82.0,0,0.01,0,270
2023-05-11,Vegetariana,165,168,82.0,0,0.02,3,1155
2023-05-11,Primavera,75,77,82.0,0,0.03,2,525
2023-05-11,Napolitana,45,46,82.0,0,0.02,1,315
2023-05-12,Pepperoni,315,318,83.5,1,0.01,3,1890
2023-05-12,Cheese,150,152,83.5,1,0.01,2,900
2023-05-12,Vegetariana,120,122,83.5,1,0.02,2,840
2023-05-12,Primavera,255,260,83.5,1,0.02,5,1785
2023-05-12,Napolitana,255,260,83.5,1,0.02,5,1785
2023-05-13,Pepperoni,120,121,83.0,1,0.01,1,720
2023-05-13,Cheese,75,76,83.0,1,0.01,1,450
2023-05-13,Vegetariana,135,138,83.0,1,0.02,3,945
2023-05-13,Primavera,60,61,83.0,1,0.02,1,420
2023-05-13,Napolitana,30,31,83.0,1,0.02,1,210
2023-05-14,Pepperoni,30,31,83.5,0,0.03,1,180
2023-05-14,Cheese,15,15,83.5,0,0.01,0,90
2023-05-14,Vegetariana,105,110,83.5,0,0.05,5,735
2023-05-14,Primavera,15,15,83.5,0,0.01,0,105
2023-05-14,Napolitana,60,61,83.5,0,0.02,1,420
2023-05-15,Pepperoni,60,61,82.0,1,0.02,1,360
2023-05-15,Cheese,30,30,82.0,1,0.01,0,180
2023-05-15,Vegetariana,75,78,82.0,1,0.04,3,525
2023-05-15,Primavera,15,15,82.0,1,0.01,0,105
2023-05-15,Napolitana,45,46,82.0,1,0.02,1,315
2023-05-16,Pepperoni,60,62,83.0,0,0.03,2,360
2023-05-16,Cheese,45,45,83.0,0,0.01,0,270
2023-05-16,Vegetariana,45,47,83.0,0,0.04,2,315
2023-05-16,Primavera,45,46,83.0,0,0.02,1,315
2023-05-16,Napolitana,60,61,83.0,0,0.02,1,420
2023-05-17,Pepperoni,15,15,83.5,1,0.02,0,90
2023-05-17,Cheese,105,107,83.5,1,0.02,2,630
2023-05-17,Vegetariana,105,108,83.5,1,0.03,3,735
2023-05-17,Primavera,30,31,83.5,1,0.04,1,210
2023-05-17,Napolitana,15,15,83.5,1,0.03,0,105
2023-05-18,Pepperoni,60,61,81.0,1,0.01,1,360
2023-05-18,Cheese,15,15,81.0,1,0.01,0,90
2023-05-18,Vegetariana,75,77,81.0,1,0.02,2,525
2023-05-18,Primavera,30,31,81.0,1,0.03,1,210
2023-05-18,Napolitana,15,15,81.0,1,0.02,0,105
2023-05-19,Pepperoni,225,227,83.0,1,0.01,2,1350
2023-05-19,Cheese,135,136,83.0,1,0.01,1,810
2023-05-19,Vegetariana,165,168,83.0,1,0.02,3,1155
2023-05-19,Primavera,105,107,83.0,1,0.02,2,735
2023-05-19,Napolitana,135,138,83.0,1,0.02,3,945
2023-05-20,Pepperoni,60,61,79.0,0,0.01,1,360
2023-05-20,Cheese,135,136,79.0,0,0.01,1,810
2023-05-20,Vegetariana,120,122,79.0,0,0.02,2,840
2023-05-20,Primavera,60,61,79.0,0,0.02,1,420
2023-05-20,Napolitana,60,61,79.0,0,0.02,1,420
2023-05-21,Pepperoni,240,247,81.5,1,0.03,7,1440
2023-05-21,Cheese,15,15,81.5,1,0.01,0,90
2023-05-21,Vegetariana,90,95,81.5,1,0.05,5,630
2023-05-21,Primavera,45,45,81.5,1,0.01,0,315
2023-05-21,Napolitana,75,77,81.5,1,0.02,2,525
2023-05-22,Pepperoni,15,15,82.5,1,0.02,0,90
2023-05-22,Cheese,45,45,82.5,1,0.01,0,270
2023-05-22,Vegetariana,75,78,82.5,1,0.04,3,525
2023-05-22,Primavera,60,61,82.5,1,0.01,1,420
2023-05-22,Napolitana,45,46,82.5,1,0.02,1,315
2023-05-23,Pepperoni,15,15,80.5,1,0.03,0,90
2023-05-23,Cheese,15,15,80.5,1,0.01,0,90
2023-05-23,Vegetariana,45,47,80.5,1,0.04,2,315
2023-05-23,Primavera,30,31,80.5,1,0.02,1,210
2023-05-23,Napolitana,30,31,80.5,1,0.02,1,210
2023-05-24,Pepperoni,15,15,80.5,1,0.02,0,90
2023-05-24,Cheese,30,31,80.5,1,0.02,1,180
2023-05-24,Vegetariana,75,77,80.5,1,0.03,2,525
2023-05-24,Primavera,45,47,80.5,1,0.04,2,315
2023-05-24,Napolitana,45,46,80.5,1,0.03,1,315
2023-05-25,Pepperoni,75,76,79.5,1,0.01,1,450
2023-05-25,Cheese,75,76,79.5,1,0.01,1,450
2023-05-25,Vegetariana,30,31,79.5,1,0.02,1,210
2023-05-25,Primavera,90,93,79.5,1,0.03,3,630
2023-05-25,Napolitana,45,46,79.5,1,0.02,1,315
2023-05-26,Pepperoni,60,61,79.5,1,0.01,1,360
2023-05-26,Cheese,90,91,79.5,1,0.01,1,540
2023-05-26,Vegetariana,180,184,79.5,1,0.02,4,1260
2023-05-26,Primavera,90,92,79.5,1,0.02,2,630
2023-05-26,Napolitana,30,31,79.5,1,0.02,1,210
2023-05-27,Pepperoni,180,182,80.5,0,0.01,2,1080
2023-05-27,Cheese,75,76,80.5,0,0.01,1,450
2023-05-27,Vegetariana,165,168,80.5,0,0.02,3,1155
2023-05-27,Primavera,75,77,80.5,0,0.02,2,525
2023-05-27,Napolitana,90,92,80.5,0,0.02,2,630
2023-05-28,Pepperoni,60,62,84.0,0,0.03,2,360
2023-05-28,Cheese,90,91,84.0,0,0.01,1,540
2023-05-28,Vegetariana,75,79,84.0,0,0.05,4,525
2023-05-28,Primavera,75,76,84.0,0,0.01,1,525
2023-05-28,Napolitana,120,122,84.0,0,0.02,2,840
2023-05-29,Pepperoni,60,61,82.0,1,0.02,1,360
2023-05-29,Cheese,60,61,82.0,1,0.01,1,360
2023-05-29,Vegetariana,75,78,82.0,1,0.04,3,525
2023-05-29,Primavera,45,45,82.0,1,0.01,0,315
2023-05-29,Napolitana,45,46,82.0,1,0.02,1,315
2023-05-30,Pepperoni,90,93,81.5,1,0.03,3,540
2023-05-30,Cheese,105,106,81.5,1,0.01,1,630
2023-05-30,Vegetariana,45,47,81.5,1,0.04,2,315
2023-05-30,Primavera,45,46,81.5,1,0.02,1,315
2023-05-30,Napolitana,30,31,81.5,1,0.02,1,210
2023-05-31,Pepperoni,75,77,82.0,1,0.02,2,450
2023-05-31,Cheese,15,15,82.0,1,0.02,0,90
2023-05-31,Vegetariana,90,93,82.0,1,0.03,3,630
2023-05-31,Primavera,120,125,82.0,1,0.04,5,840
2023-05-31,Napolitana,90,93,82.0,1,0.03,3,630
2023-06-01,Pepperoni,60,61,80.5,1,0.01,1,360
2023-06-01,Cheese,75,76,80.5,1,0.01,1,450
2023-06-01,Vegetariana,165,168,80.5,1,0.02,3,1155
2023-06-01,Primavera,105,108,80.5,1,0.03,3,735
2023-06-01,Napolitana,45,46,80.5,1,0.02,1,315
2023-06-02,Pepperoni,240,242,80.5,1,0.01,2,1440
2023-06-02,Cheese,60,61,80.5,1,0.01,1,360
2023-06-02,Vegetariana,330,337,80.5,1,0.02,7,2310
2023-06-02,Primavera,120,122,80.5,1,0.02,2,840
2023-06-02,Napolitana,165,168,80.5,1,0.02,3,1155
2023-06-03,Pepperoni,135,136,80.5,1,0.01,1,810
2023-06-03,Cheese,60,61,80.5,1,0.01,1,360
2023-06-03,Vegetariana,165,168,80.5,1,0.02,3,1155
2023-06-03,Primavera,45,46,80.5,1,0.02,1,315
2023-06-03,Napolitana,60,61,80.5,1,0.02,1,420
2023-06-04,Pepperoni,120,124,81.5,1,0.03,4,720
2023-06-04,Cheese,45,45,81.5,1,0.01,0,270
2023-06-04,Vegetariana,150,158,81.5,1,0.05,8,1050
2023-06-04,Primavera,105,106,81.5,1,0.01,1,735
2023-06-04,Napolitana,75,77,81.5,1,0.02,2,525
2023-06-05,Pepperoni,150,153,82.5,1,0.02,3,900
2023-06-05,Cheese,60,61,82.5,1,0.01,1,360
2023-06-05,Vegetariana,105,109,82.5,1,0.04,4,735
2023-06-05,Primavera,90,91,82.5,1,0.01,1,630
2023-06-05,Napolitana,30,31,82.5,1,0.02,1,210
2023-06-06,Pepperoni,135,139,78.0,1,0.03,4,810
2023-06-06,Cheese,45,45,78.0,1,0.01,0,270
2023-06-06,Vegetariana,60,62,78.0,1,0.04,2,420
2023-06-06,Primavera,60,61,78.0,1,0.02,1,420
2023-06-06,Napolitana,60,61,78.0,1,0.02,1,420
2023-06-07,Pepperoni,30,31,82.0,1,0.02,1,180
2023-06-07,Cheese,75,77,82.0,1,0.02,2,450
2023-06-07,Vegetariana,105,108,82.0,1,0.03,3,735
2023-06-07,Primavera,30,31,82.0,1,0.04,1,210
2023-06-07,Napolitana,30,31,82.0,1,0.03,1,210
2023-06-08,Pepperoni,165,167,83.5,1,0.01,2,990
2023-06-08,Cheese,75,76,83.5,1,0.01,1,450
2023-06-08,Vegetariana,135,138,83.5,1,0.02,3,945
2023-06-08,Primavera,60,62,83.5,1,0.03,2,420
2023-06-08,Napolitana,60,61,83.5,1,0.02,1,420
2023-06-09,Pepperoni,165,167,84.0,0,0.01,2,990
2023-06-09,Cheese,180,182,84.0,0,0.01,2,1080
2023-06-09,Vegetariana,195,199,84.0,0,0.02,4,1365
2023-06-09,Primavera,165,168,84.0,0,0.02,3,1155
2023-06-09,Napolitana,75,77,84.0,0,0.02,2,525
2023-06-10,Pepperoni,180,182,84.0,0,0.01,2,1080
2023-06-10,Cheese,60,61,84.0,0,0.01,1,360
2023-06-10,Vegetariana,330,337,84.0,0,0.02,7,2310
2023-06-10,Primavera,135,138,84.0,0,0.02,3,945
2023-06-10,Napolitana,60,61,84.0,0,0.02,1,420
2023-06-11,Pepperoni,15,15,84.0,1,0.03,0,90
2023-06-11,Cheese,45,45,84.0,1,0.01,0,270
2023-06-11,Vegetariana,105,110,84.0,1,0.05,5,735
2023-06-11,Primavera,75,76,84.0,1,0.01,1,525
2023-06-11,Napolitana,75,77,84.0,1,0.02,2,525
2023-06-12,Pepperoni,60,61,83.0,1,0.02,1,360
2023-06-12,Cheese,30,30,83.0,1,0.01,0,180
2023-06-12,Vegetariana,90,94,83.0,1,0.04,4,630
2023-06-12,Primavera,45,45,83.0,1,0.01,0,315
2023-06-12,Napolitana,90,92,83.0,1,0.02,2,630
2023-06-13,Pepperoni,30,31,85.0,0,0.03,1,180
2023-06-13,Cheese,30,30,85.0,0,0.01,0,180
2023-06-13,Vegetariana,105,109,85.0,0,0.04,4,735
2023-06-13,Primavera,90,92,85.0,0,0.02,2,630
2023-06-13,Napolitana,105,107,85.0,0,0.02,2,735
2023-06-14,Pepperoni,60,61,85.0,0,0.02,1,360
2023-06-14,Cheese,30,31,85.0,0,0.02,1,180
2023-06-14,Vegetariana,60,62,85.0,0,0.03,2,420
2023-06-14,Primavera,15,16,85.0,0,0.04,1,105
2023-06-14,Napolitana,75,77,85.0,0,0.03,2,525
2023-06-15,Pepperoni,90,91,87.0,0,0.01,1,540
2023-06-15,Cheese,30,30,87.0,0,0.01,0,180
2023-06-15,Vegetariana,195,199,87.0,0,0.02,4,1365
2023-06-15,Primavera,30,31,87.0,0,0.03,1,210
2023-06-15,Napolitana,45,46,87.0,0,0.02,1,315
2023-06-16,Pepperoni,300,303,88.0,1,0.01,3,1800
2023-06-16,Cheese,105,106,88.0,1,0.01,1,630
2023-06-16,Vegetariana,135,138,88.0,1,0.02,3,945
2023-06-16,Primavera,165,168,88.0,1,0.02,3,1155
2023-06-16,Napolitana,120,122,88.0,1,0.02,2,840
2023-06-17,Pepperoni,330,333,86.0,1,0.01,3,1980
2023-06-17,Cheese,135,136,86.0,1,0.01,1,810
2023-06-17,Vegetariana,150,153,86.0,1,0.02,3,1050
2023-06-17,Primavera,105,107,86.0,1,0.02,2,735
2023-06-17,Napolitana,60,61,86.0,1,0.02,1,420
2023-06-18,Pepperoni,105,108,84.0,1,0.03,3,630
2023-06-18,Cheese,150,152,84.0,1,0.01,2,900
2023-06-18,Vegetariana,150,158,84.0,1,0.05,8,1050
2023-06-18,Primavera,30,30,84.0,1,0.01,0,210
2023-06-18,Napolitana,30,31,84.0,1,0.02,1,210
2023-06-19,Pepperoni,45,46,82.5,1,0.02,1,270
2023-06-19,Cheese,75,76,82.5,1,0.01,1,450
2023-06-19,Vegetariana,75,78,82.5,1,0.04,3,525
2023-06-19,Primavera,60,61,82.5,1,0.01,1,420
2023-06-19,Napolitana,30,31,82.5,1,0.02,1,210
2023-06-20,Pepperoni,45,46,82.0,1,0.03,1,270
2023-06-20,Cheese,75,76,82.0,1,0.01,1,450
2023-06-20,Vegetariana,45,47,82.0,1,0.04,2,315
2023-06-20,Primavera,75,77,82.0,1,0.02,2,525
2023-06-20,Napolitana,15,15,82.0,1,0.02,0,105
2023-06-21,Pepperoni,75,77,82.0,0,0.02,2,450
2023-06-21,Cheese,15,15,82.0,0,0.02,0,90
2023-06-21,Vegetariana,165,170,82.0,0,0.03,5,1155
2023-06-21,Primavera,15,16,82.0,0,0.04,1,105
2023-06-21,Napolitana,60,62,82.0,0,0.03,2,420
2023-06-22,Pepperoni,105,106,83.0,1,0.01,1,630
2023-06-22,Cheese,60,61,83.0,1,0.01,1,360
2023-06-22,Vegetariana,240,245,83.0,1,0.02,5,1680
2023-06-22,Primavera,45,46,83.0,1,0.03,1,315
2023-06-22,Napolitana,90,92,83.0,1,0.02,2,630
2023-06-23,Pepperoni,120,121,86.0,0,0.01,1,720
2023-06-23,Cheese,105,106,86.0,0,0.01,1,630
2023-06-23,Vegetariana,210,214,86.0,0,0.02,4,1470
2023-06-23,Primavera,210,214,86.0,0,0.02,4,1470
2023-06-23,Napolitana,90,92,86.0,0,0.02,2,630
2023-06-24,Pepperoni,180,182,83.5,1,0.01,2,1080
2023-06-24,Cheese,120,121,83.5,1,0.01,1,720
2023-06-24,Vegetariana,255,260,83.5,1,0.02,5,1785
2023-06-24,Primavera,135,138,83.5,1,0.02,3,945
2023-06-24,Napolitana,135,138,83.5,1,0.02,3,945
2023-06-25,Pepperoni,135,139,83.0,1,0.03,4,810
2023-06-25,Cheese,15,15,83.0,1,0.01,0,90
2023-06-25,Vegetariana,180,189,83.0,1,0.05,9,1260
2023-06-25,Primavera,45,45,83.0,1,0.01,0,315
2023-06-25,Napolitana,15,15,83.0,1,0.02,0,105
2023-06-26,Pepperoni,75,77,83.5,1,0.02,2,450
2023-06-26,Cheese,30,30,83.5,1,0.01,0,180
2023-06-26,Vegetariana,120,125,83.5,1,0.04,5,840
2023-06-26,Primavera,45,45,83.5,1,0.01,0,315
2023-06-26,Napolitana,30,31,83.5,1,0.02,1,210
2023-06-27,Pepperoni,45,46,86.5,0,0.03,1,270
2023-06-27,Cheese,30,30,86.5,0,0.01,0,180
2023-06-27,Vegetariana,30,31,86.5,0,0.04,1,210
2023-06-27,Primavera,105,107,86.5,0,0.02,2,735
2023-06-27,Napolitana,45,46,86.5,0,0.02,1,315
2023-06-28,Pepperoni,45,46,85.5,0,0.02,1,270
2023-06-28,Cheese,30,31,85.5,0,0.02,1,180
2023-06-28,Vegetariana,75,77,85.5,0,0.03,2,525
2023-06-28,Primavera,30,31,85.5,0,0.04,1,210
2023-06-28,Napolitana,30,31,85.5,0,0.03,1,210
2023-06-29,Pepperoni,120,121,87.5,1,0.01,1,720
2023-06-29,Cheese,75,76,87.5,1,0.01,1,450
2023-06-29,Vegetariana,105,107,87.5,1,0.02,2,735
2023-06-29,Primavera,105,108,87.5,1,0.03,3,735
2023-06-29,Napolitana,45,46,87.5,1,0.02,1,315
2023-06-30,Pepperoni,285,288,85.5,1,0.01,3,1710
2023-06-30,Cheese,180,182,85.5,1,0.01,2,1080
2023-06-30,Vegetariana,375,383,85.5,1,0.02,8,2625
2023-06-30,Primavera,120,122,85.5,1,0.02,2,840
2023-06-30,Napolitana,30,31,85.5,1,0.02,1,210
2023-07-01,Pepperoni,225,227,84.5,1,0.01,2,1350
2023-07-01,Cheese,120,121,84.5,1,0.01,1,720
2023-07-01,Vegetariana,135,138,84.5,1,0.02,3,945
2023-07-01,Primavera,120,122,84.5,1,0.02,2,840
2023-07-01,Napolitana,105,107,84.5,1,0.02,2,735
2023-07-02,Pepperoni,45,46,85.0,1,0.03,1,270
2023-07-02,Cheese,60,61,85.0,1,0.01,1,360
2023-07-02,Vegetariana,135,142,85.0,1,0.05,7,945
2023-07-02,Primavera,30,30,85.0,1,0.01,0,210
2023-07-02,Napolitana,60,61,85.0,1,0.02,1,420
2023-07-03,Pepperoni,90,92,86.5,1,0.02,2,540
2023-07-03,Cheese,105,106,86.5,1,0.01,1,630
2023-07-03,Vegetariana,75,78,86.5,1,0.04,3,525
2023-07-03,Primavera,45,45,86.5,1,0.01,0,315
2023-07-03,Napolitana,30,31,86.5,1,0.02,1,210
2023-07-04,Pepperoni,60,62,86.5,1,0.03,2,360
2023-07-04,Cheese,45,45,86.5,1,0.01,0,270
2023-07-04,Vegetariana,180,187,86.5,1,0.04,7,1260
2023-07-04,Primavera,90,92,86.5,1,0.02,2,630
2023-07-04,Napolitana,15,15,86.5,1,0.02,0,105
2023-07-05,Pepperoni,60,61,87.0,1,0.02,1,360
2023-07-05,Cheese,15,15,87.0,1,0.02,0,90
2023-07-05,Vegetariana,75,77,87.0,1,0.03,2,525
2023-07-05,Primavera,60,62,87.0,1,0.04,2,420
2023-07-05,Napolitana,45,46,87.0,1,0.03,1,315
2023-07-06,Pepperoni,105,106,88.5,1,0.01,1,630
2023-07-06,Cheese,60,61,88.5,1,0.01,1,360
2023-07-06,Vegetariana,150,153,88.5,1,0.02,3,1050
2023-07-06,Primavera,90,93,88.5,1,0.03,3,630
2023-07-06,Napolitana,60,61,88.5,1,0.02,1,420
2023-07-07,Pepperoni,375,379,88.5,1,0.01,4,2250
2023-07-07,Cheese,165,167,88.5,1,0.01,2,990
2023-07-07,Vegetariana,285,291,88.5,1,0.02,6,1995
2023-07-07,Primavera,120,122,88.5,1,0.02,2,840
2023-07-07,Napolitana,240,245,88.5,1,0.02,5,1680
2023-07-08,Pepperoni,60,61,86.0,0,0.01,1,360
2023-07-08,Cheese,150,152,86.0,0,0.01,2,900
2023-07-08,Vegetariana,120,122,86.0,0,0.02,2,840
2023-07-08,Primavera,105,107,86.0,0,0.02,2,735
2023-07-08,Napolitana,30,31,86.0,0,0.02,1,210
2023-07-09,Pepperoni,60,62,84.5,0,0.03,2,360
2023-07-09,Cheese,105,106,84.5,0,0.01,1,630
2023-07-09,Vegetariana,135,142,84.5,0,0.05,7,945
2023-07-09,Primavera,30,30,84.5,0,0.01,0,210
2023-07-09,Napolitana,90,92,84.5,0,0.02,2,630
2023-07-10,Pepperoni,90,92,86.5,0,0.02,2,540
2023-07-10,Cheese,75,76,86.5,0,0.01,1,450
2023-07-10,Vegetariana,45,47,86.5,0,0.04,2,315
2023-07-10,Primavera,30,30,86.5,0,0.01,0,210
2023-07-10,Napolitana,15,15,86.5,0,0.02,0,105
2023-07-11,Pepperoni,30,31,86.5,0,0.03,1,180
2023-07-11,Cheese,15,15,86.5,0,0.01,0,90
2023-07-11,Vegetariana,30,31,86.5,0,0.04,1,210
2023-07-11,Primavera,45,46,86.5,0,0.02,1,315
2023-07-11,Napolitana,45,46,86.5,0,0.02,1,315
2023-07-12,Pepperoni,120,122,88.5,0,0.02,2,720
2023-07-12,Cheese,15,15,88.5,0,0.02,0,90
2023-07-12,Vegetariana,30,31,88.5,0,0.03,1,210
2023-07-12,Primavera,75,78,88.5,0,0.04,3,525
2023-07-12,Napolitana,30,31,88.5,0,0.03,1,210
2023-07-13,Pepperoni,60,61,87.5,1,0.01,1,360
2023-07-13,Cheese,90,91,87.5,1,0.01,1,540
2023-07-13,Vegetariana,135,138,87.5,1,0.02,3,945
2023-07-13,Primavera,75,77,87.5,1,0.03,2,525
2023-07-13,Napolitana,75,77,87.5,1,0.02,2,525
2023-07-14,Pepperoni,270,273,87.0,1,0.01,3,1620
2023-07-14,Cheese,135,136,87.0,1,0.01,1,810
2023-07-14,Vegetariana,150,153,87.0,1,0.02,3,1050
2023-07-14,Primavera,150,153,87.0,1,0.02,3,1050
2023-07-14,Napolitana,120,122,87.0,1,0.02,2,840
2023-07-15,Pepperoni,315,318,84.0,1,0.01,3,1890
2023-07-15,Cheese,75,76,84.0,1,0.01,1,450
2023-07-15,Vegetariana,75,77,84.0,1,0.02,2,525
2023-07-15,Primavera,120,122,84.0,1,0.02,2,840
2023-07-15,Napolitana,105,107,84.0,1,0.02,2,735
2023-07-16,Pepperoni,150,155,85.0,1,0.03,5,900
2023-07-16,Cheese,30,30,85.0,1,0.01,0,180
2023-07-16,Vegetariana,135,142,85.0,1,0.05,7,945
2023-07-16,Primavera,120,121,85.0,1,0.01,1,840
2023-07-16,Napolitana,30,31,85.0,1,0.02,1,210
2023-07-17,Pepperoni,90,92,85.5,1,0.02,2,540
2023-07-17,Cheese,45,45,85.5,1,0.01,0,270
2023-07-17,Vegetariana,135,140,85.5,1,0.04,5,945
2023-07-17,Primavera,45,45,85.5,1,0.01,0,315
2023-07-17,Napolitana,60,61,85.5,1,0.02,1,420
2023-07-18,Pepperoni,45,46,84.5,1,0.03,1,270
2023-07-18,Cheese,45,45,84.5,1,0.01,0,270
2023-07-18,Vegetariana,90,94,84.5,1,0.04,4,630
2023-07-18,Primavera,75,77,84.5,1,0.02,2,525
2023-07-18,Napolitana,90,92,84.5,1,0.02,2,630
2023-07-19,Pepperoni,60,61,85.5,1,0.02,1,360
2023-07-19,Cheese,30,31,85.5,1,0.02,1,180
2023-07-19,Vegetariana,30,31,85.5,1,0.03,1,210
2023-07-19,Primavera,60,62,85.5,1,0.04,2,420
2023-07-19,Napolitana,45,46,85.5,1,0.03,1,315
2023-07-20,Pepperoni,150,152,89.0,1,0.01,2,900
2023-07-20,Cheese,60,61,89.0,1,0.01,1,360
2023-07-20,Vegetariana,105,107,89.0,1,0.02,2,735
2023-07-20,Primavera,90,93,89.0,1,0.03,3,630
2023-07-20,Napolitana,15,15,89.0,1,0.02,0,105
2023-07-21,Pepperoni,165,167,88.0,0,0.01,2,990
2023-07-21,Cheese,105,106,88.0,0,0.01,1,630
2023-07-21,Vegetariana,195,199,88.0,0,0.02,4,1365
2023-07-21,Primavera,135,138,88.0,0,0.02,3,945
2023-07-21,Napolitana,120,122,88.0,0,0.02,2,840
2023-07-22,Pepperoni,165,167,89.0,0,0.01,2,990
2023-07-22,Cheese,135,136,89.0,0,0.01,1,810
2023-07-22,Vegetariana,225,230,89.0,0,0.02,5,1575
2023-07-22,Primavera,135,138,89.0,0,0.02,3,945
2023-07-22,Napolitana,120,122,89.0,0,0.02,2,840
2023-07-23,Pepperoni,60,62,90.0,0,0.03,2,360
2023-07-23,Cheese,30,30,90.0,0,0.01,0,180
2023-07-23,Vegetariana,45,47,90.0,0,0.05,2,315
2023-07-23,Primavera,90,91,90.0,0,0.01,1,630
2023-07-23,Napolitana,60,61,90.0,0,0.02,1,420
2023-07-24,Pepperoni,75,77,89.5,0,0.02,2,450
2023-07-24,Cheese,90,91,89.5,0,0.01,1,540
2023-07-24,Vegetariana,105,109,89.5,0,0.04,4,735
2023-07-24,Primavera,90,91,89.5,0,0.01,1,630
2023-07-24,Napolitana,75,77,89.5,0,0.02,2,525
2023-07-25,Pepperoni,60,62,89.0,0,0.03,2,360
2023-07-25,Cheese,60,61,89.0,0,0.01,1,360
2023-07-25,Vegetariana,90,94,89.0,0,0.04,4,630
2023-07-25,Primavera,90,92,89.0,0,0.02,2,630
2023-07-25,Napolitana,15,15,89.0,0,0.02,0,105
2023-07-26,Pepperoni,15,15,83.0,1,0.02,0,90
2023-07-26,Cheese,60,61,83.0,1,0.02,1,360
2023-07-26,Vegetariana,75,77,83.0,1,0.03,2,525
2023-07-26,Primavera,60,62,83.0,1,0.04,2,420
2023-07-26,Napolitana,90,93,83.0,1,0.03,3,630
2023-07-27,Pepperoni,60,61,83.0,1,0.01,1,360
2023-07-27,Cheese,60,61,83.0,1,0.01,1,360
2023-07-27,Vegetariana,45,46,83.0,1,0.02,1,315
2023-07-27,Primavera,75,77,83.0,1,0.03,2,525
2023-07-27,Napolitana,90,92,83.0,1,0.02,2,630
2023-07-28,Pepperoni,150,152,82.0,1,0.01,2,900
2023-07-28,Cheese,120,121,82.0,1,0.01,1,720
2023-07-28,Vegetariana,150,153,82.0,1,0.02,3,1050
2023-07-28,Primavera,105,107,82.0,1,0.02,2,735
2023-07-28,Napolitana,75,77,82.0,1,0.02,2,525
2023-07-29,Pepperoni,255,258,87.0,1,0.01,3,1530
2023-07-29,Cheese,60,61,87.0,1,0.01,1,360
2023-07-29,Vegetariana,120,122,87.0,1,0.02,2,840
2023-07-29,Primavera,45,46,87.0,1,0.02,1,315
2023-07-29,Napolitana,30,31,87.0,1,0.02,1,210
2023-07-30,Pepperoni,75,77,88.0,0,0.03,2,450
2023-07-30,Cheese,15,15,88.0,0,0.01,0,90
2023-07-30,Vegetariana,30,32,88.0,0,0.05,2,210
2023-07-30,Primavera,45,45,88.0,0,0.01,0,315
2023-07-30,Napolitana,75,77,88.0,0,0.02,2,525
2023-07-31,Pepperoni,105,107,87.5,1,0.02,2,630
2023-07-31,Cheese,90,91,87.5,1,0.01,1,540
2023-07-31,Vegetariana,15,16,87.5,1,0.04,1,105
2023-07-31,Primavera,75,76,87.5,1,0.01,1,525
2023-07-31,Napolitana,75,77,87.5,1,0.02,2,525
2023-08-01,Pepperoni,90,93,87.5,1,0.03,3,540
2023-08-01,Cheese,75,76,87.5,1,0.01,1,450
2023-08-01,Vegetariana,120,125,87.5,1,0.04,5,840
2023-08-01,Primavera,120,122,87.5,1,0.02,2,840
2023-08-01,Napolitana,45,46,87.5,1,0.02,1,315
2023-08-02,Pepperoni,90,92,86.5,1,0.02,2,540
2023-08-02,Cheese,15,15,86.5,1,0.02,0,90
2023-08-02,Vegetariana,105,108,86.5,1,0.03,3,735
2023-08-02,Primavera,60,62,86.5,1,0.04,2,420
2023-08-02,Napolitana,120,124,86.5,1,0.03,4,840
2023-08-03,Pepperoni,75,76,85.5,1,0.01,1,450
2023-08-03,Cheese,105,106,85.5,1,0.01,1,630
2023-08-03,Vegetariana,75,77,85.5,1,0.02,2,525
2023-08-03,Primavera,30,31,85.5,1,0.03,1,210
2023-08-03,Napolitana,135,138,85.5,1,0.02,3,945
2023-08-04,Pepperoni,120,121,84.0,1,0.01,1,720
2023-08-04,Cheese,60,61,84.0,1,0.01,1,360
2023-08-04,Vegetariana,150,153,84.0,1,0.02,3,1050
2023-08-04,Primavera,180,184,84.0,1,0.02,4,1260
2023-08-04,Napolitana,45,46,84.0,1,0.02,1,315
2023-08-05,Pepperoni,165,167,87.5,1,0.01,2,990
2023-08-05,Cheese,120,121,87.5,1,0.01,1,720
2023-08-05,Vegetariana,255,260,87.5,1,0.02,5,1785
2023-08-05,Primavera,135,138,87.5,1,0.02,3,945
2023-08-05,Napolitana,60,61,87.5,1,0.02,1,420
2023-08-06,Pepperoni,60,62,88.5,1,0.03,2,360
2023-08-06,Cheese,75,76,88.5,1,0.01,1,450
2023-08-06,Vegetariana,60,63,88.5,1,0.05,3,420
2023-08-06,Primavera,45,45,88.5,1,0.01,0,315
2023-08-06,Napolitana,90,92,88.5,1,0.02,2,630
2023-08-07,Pepperoni,60,61,89.0,0,0.02,1,360
2023-08-07,Cheese,45,45,89.0,0,0.01,0,270
2023-08-07,Vegetariana,15,16,89.0,0,0.04,1,105
2023-08-07,Primavera,30,30,89.0,0,0.01,0,210
2023-08-07,Napolitana,90,92,89.0,0,0.02,2,630
2023-08-08,Pepperoni,30,31,89.0,1,0.03,1,180
2023-08-08,Cheese,15,15,89.0,1,0.01,0,90
2023-08-08,Vegetariana,120,125,89.0,1,0.04,5,840
2023-08-08,Primavera,30,31,89.0,1,0.02,1,210
2023-08-08,Napolitana,30,31,89.0,1,0.02,1,210
2023-08-09,Pepperoni,45,46,89.0,1,0.02,1,270
2023-08-09,Cheese,60,61,89.0,1,0.02,1,360
2023-08-09,Vegetariana,45,46,89.0,1,0.03,1,315
2023-08-09,Primavera,30,31,89.0,1,0.04,1,210
2023-08-09,Napolitana,30,31,89.0,1,0.03,1,210
2023-08-10,Pepperoni,60,61,87.5,1,0.01,1,360
2023-08-10,Cheese,30,30,87.5,1,0.01,0,180
2023-08-10,Vegetariana,165,168,87.5,1,0.02,3,1155
2023-08-10,Primavera,150,155,87.5,1,0.03,5,1050
2023-08-10,Napolitana,75,77,87.5,1,0.02,2,525
2023-08-11,Pepperoni,75,76,87.0,1,0.01,1,450
2023-08-11,Cheese,75,76,87.0,1,0.01,1,450
2023-08-11,Vegetariana,195,199,87.0,1,0.02,4,1365
2023-08-11,Primavera,60,61,87.0,1,0.02,1,420
2023-08-11,Napolitana,135,138,87.0,1,0.02,3,945
2023-08-12,Pepperoni,210,212,88.0,1,0.01,2,1260
2023-08-12,Cheese,75,76,88.0,1,0.01,1,450
2023-08-12,Vegetariana,135,138,88.0,1,0.02,3,945
2023-08-12,Primavera,60,61,88.0,1,0.02,1,420
2023-08-12,Napolitana,90,92,88.0,1,0.02,2,630
2023-08-13,Pepperoni,30,31,88.0,1,0.03,1,180
2023-08-13,Cheese,30,30,88.0,1,0.01,0,180
2023-08-13,Vegetariana,165,173,88.0,1,0.05,8,1155
2023-08-13,Primavera,105,106,88.0,1,0.01,1,735
2023-08-13,Napolitana,75,77,88.0,1,0.02,2,525
2023-08-14,Pepperoni,135,138,88.5,0,0.02,3,810
2023-08-14,Cheese,75,76,88.5,0,0.01,1,450
2023-08-14,Vegetariana,60,62,88.5,0,0.04,2,420
2023-08-14,Primavera,15,15,88.5,0,0.01,0,105
2023-08-14,Napolitana,30,31,88.5,0,0.02,1,210
2023-08-15,Pepperoni,45,46,87.0,1,0.03,1,270
2023-08-15,Cheese,15,15,87.0,1,0.01,0,90
2023-08-15,Vegetariana,75,78,87.0,1,0.04,3,525
2023-08-15,Primavera,45,46,87.0,1,0.02,1,315
2023-08-15,Napolitana,15,15,87.0,1,0.02,0,105
2023-08-16,Pepperoni,105,107,85.0,1,0.02,2,630
2023-08-16,Cheese,75,77,85.0,1,0.02,2,450
2023-08-16,Vegetariana,45,46,85.0,1,0.03,1,315
2023-08-16,Primavera,105,109,85.0,1,0.04,4,735
2023-08-16,Napolitana,45,46,85.0,1,0.03,1,315
2023-08-17,Pepperoni,45,45,84.0,1,0.01,0,270
2023-08-17,Cheese,45,45,84.0,1,0.01,0,270
2023-08-17,Vegetariana,120,122,84.0,1,0.02,2,840
2023-08-17,Primavera,90,93,84.0,1,0.03,3,630
2023-08-17,Napolitana,75,77,84.0,1,0.02,2,525
2023-08-18,Pepperoni,180,182,83.5,1,0.01,2,1080
2023-08-18,Cheese,60,61,83.5,1,0.01,1,360
2023-08-18,Vegetariana,165,168,83.5,1,0.02,3,1155
2023-08-18,Primavera,90,92,83.5,1,0.02,2,630
2023-08-18,Napolitana,60,61,83.5,1,0.02,1,420
2023-08-19,Pepperoni,135,136,84.5,1,0.01,1,810
2023-08-19,Cheese,105,106,84.5,1,0.01,1,630
2023-08-19,Vegetariana,210,214,84.5,1,0.02,4,1470
2023-08-19,Primavera,45,46,84.5,1,0.02,1,315
2023-08-19,Napolitana,60,61,84.5,1,0.02,1,420
2023-08-20,Pepperoni,75,77,84.0,1,0.03,2,450
2023-08-20,Cheese,15,15,84.0,1,0.01,0,90
2023-08-20,Vegetariana,75,79,84.0,1,0.05,4,525
2023-08-20,Primavera,120,121,84.0,1,0.01,1,840
2023-08-20,Napolitana,90,92,84.0,1,0.02,2,630
2023-08-21,Pepperoni,60,61,86.5,1,0.02,1,360
2023-08-21,Cheese,60,61,86.5,1,0.01,1,360
2023-08-21,Vegetariana,60,62,86.5,1,0.04,2,420
2023-08-21,Primavera,45,45,86.5,1,0.01,0,315
2023-08-21,Napolitana,15,15,86.5,1,0.02,0,105
2023-08-22,Pepperoni,90,93,86.0,1,0.03,3,540
2023-08-22,Cheese,105,106,86.0,1,0.01,1,630
2023-08-22,Vegetariana,105,109,86.0,1,0.04,4,735
2023-08-22,Primavera,15,15,86.0,1,0.02,0,105
2023-08-22,Napolitana,45,46,86.0,1,0.02,1,315
2023-08-23,Pepperoni,60,61,86.5,1,0.02,1,360
2023-08-23,Cheese,60,61,86.5,1,0.02,1,360
2023-08-23,Vegetariana,120,124,86.5,1,0.03,4,840
2023-08-23,Primavera,15,16,86.5,1,0.04,1,105
2023-08-23,Napolitana,90,93,86.5,1,0.03,3,630
2023-08-24,Pepperoni,75,76,86.0,1,0.01,1,450
2023-08-24,Cheese,90,91,86.0,1,0.01,1,540
2023-08-24,Vegetariana,195,199,86.0,1,0.02,4,1365
2023-08-24,Primavera,180,185,86.0,1,0.03,5,1260
2023-08-24,Napolitana,60,61,86.0,1,0.02,1,420
2023-08-25,Pepperoni,300,303,87.0,1,0.01,3,1800
2023-08-25,Cheese,60,61,87.0,1,0.01,1,360
2023-08-25,Vegetariana,210,214,87.0,1,0.02,4,1470
2023-08-25,Primavera,285,291,87.0,1,0.02,6,1995
2023-08-25,Napolitana,75,77,87.0,1,0.02,2,525
2023-08-26,Pepperoni,210,212,86.0,0,0.01,2,1260
2023-08-26,Cheese,150,152,86.0,0,0.01,2,900
2023-08-26,Vegetariana,210,214,86.0,0,0.02,4,1470
2023-08-26,Primavera,195,199,86.0,0,0.02,4,1365
2023-08-26,Napolitana,120,122,86.0,0,0.02,2,840
2023-08-27,Pepperoni,60,62,86.5,1,0.03,2,360
2023-08-27,Cheese,75,76,86.5,1,0.01,1,450
2023-08-27,Vegetariana,75,79,86.5,1,0.05,4,525
2023-08-27,Primavera,75,76,86.5,1,0.01,1,525
2023-08-27,Napolitana,45,46,86.5,1,0.02,1,315
2023-08-28,Pepperoni,105,107,85.5,1,0.02,2,630
2023-08-28,Cheese,90,91,85.5,1,0.01,1,540
2023-08-28,Vegetariana,15,16,85.5,1,0.04,1,105
2023-08-28,Primavera,15,15,85.5,1,0.01,0,105
2023-08-28,Napolitana,30,31,85.5,1,0.02,1,210
2023-08-29,Pepperoni,150,155,85.5,1,0.03,5,900
2023-08-29,Cheese,15,15,85.5,1,0.01,0,90
2023-08-29,Vegetariana,135,140,85.5,1,0.04,5,945
2023-08-29,Primavera,75,77,85.5,1,0.02,2,525
2023-08-29,Napolitana,15,15,85.5,1,0.02,0,105
2023-08-30,Pepperoni,30,31,88.5,0,0.02,1,180
2023-08-30,Cheese,15,15,88.5,0,0.02,0,90
2023-08-30,Vegetariana,15,15,88.5,0,0.03,0,105
2023-08-30,Primavera,45,47,88.5,0,0.04,2,315
2023-08-30,Napolitana,30,31,88.5,0,0.03,1,210
2023-08-31,Pepperoni,30,30,87.5,1,0.01,0,180
2023-08-31,Cheese,30,30,87.5,1,0.01,0,180
2023-08-31,Vegetariana,90,92,87.5,1,0.02,2,630
2023-08-31,Primavera,60,62,87.5,1,0.03,2,420
2023-08-31,Napolitana,30,31,87.5,1,0.02,1,210
2023-09-01,Pepperoni,195,197,85.5,1,0.01,2,1170
2023-09-01,Cheese,165,167,85.5,1,0.01,2,990
2023-09-01,Vegetariana,240,245,85.5,1,0.02,5,1680
2023-09-01,Primavera,225,230,85.5,1,0.02,5,1575
2023-09-01,Napolitana,30,31,85.5,1,0.02,1,210
2023-09-02,Pepperoni,195,197,84.0,1,0.01,2,1170
2023-09-02,Cheese,30,30,84.0,1,0.01,0,180
2023-09-02,Vegetariana,225,230,84.0,1,0.02,5,1575
2023-09-02,Primavera,105,107,84.0,1,0.02,2,735
2023-09-02,Napolitana,75,77,84.0,1,0.02,2,525
2023-09-03,Pepperoni,75,77,84.0,0,0.03,2,450
2023-09-03,Cheese,60,61,84.0,0,0.01,1,360
2023-09-03,Vegetariana,30,32,84.0,0,0.05,2,210
2023-09-03,Primavera,30,30,84.0,0,0.01,0,210
2023-09-03,Napolitana,30,31,84.0,0,0.02,1,210
2023-09-04,Pepperoni,30,31,86.5,0,0.02,1,180
2023-09-04,Cheese,45,45,86.5,0,0.01,0,270
2023-09-04,Vegetariana,60,62,86.5,0,0.04,2,420
2023-09-04,Primavera,15,15,86.5,0,0.01,0,105
2023-09-04,Napolitana,75,77,86.5,0,0.02,2,525
2023-09-05,Pepperoni,60,62,86.5,0,0.03,2,360
2023-09-05,Cheese,45,45,86.5,0,0.01,0,270
2023-09-05,Vegetariana,135,140,86.5,0,0.04,5,945
2023-09-05,Primavera,30,31,86.5,0,0.02,1,210
2023-09-05,Napolitana,15,15,86.5,0,0.02,0,105
2023-09-06,Pepperoni,90,92,85.0,0,0.02,2,540
2023-09-06,Cheese,30,31,85.0,0,0.02,1,180
2023-09-06,Vegetariana,135,139,85.0,0,0.03,4,945
2023-09-06,Primavera,15,16,85.0,0,0.04,1,105
2023-09-06,Napolitana,90,93,85.0,0,0.03,3,630
2023-09-07,Pepperoni,135,136,86.0,0,0.01,1,810
2023-09-07,Cheese,30,30,86.0,0,0.01,0,180
2023-09-07,Vegetariana,180,184,86.0,0,0.02,4,1260
2023-09-07,Primavera,120,124,86.0,0,0.03,4,840
2023-09-07,Napolitana,30,31,86.0,0,0.02,1,210
2023-09-08,Pepperoni,255,258,84.0,0,0.01,3,1530
2023-09-08,Cheese,135,136,84.0,0,0.01,1,810
2023-09-08,Vegetariana,195,199,84.0,0,0.02,4,1365
2023-09-08,Primavera,90,92,84.0,0,0.02,2,630
2023-09-08,Napolitana,45,46,84.0,0,0.02,1,315
2023-09-09,Pepperoni,120,121,84.5,1,0.01,1,720
2023-09-09,Cheese,75,76,84.5,1,0.01,1,450
2023-09-09,Vegetariana,330,337,84.5,1,0.02,7,2310
2023-09-09,Primavera,30,31,84.5,1,0.02,1,210
2023-09-09,Napolitana,120,122,84.5,1,0.02,2,840
2023-09-10,Pepperoni,45,46,84.0,1,0.03,1,270
2023-09-10,Cheese,105,106,84.0,1,0.01,1,630
2023-09-10,Vegetariana,105,110,84.0,1,0.05,5,735
2023-09-10,Primavera,30,30,84.0,1,0.01,0,210
2023-09-10,Napolitana,60,61,84.0,1,0.02,1,420
2023-09-11,Pepperoni,75,77,86.0,0,0.02,2,450
2023-09-11,Cheese,45,45,86.0,0,0.01,0,270
2023-09-11,Vegetariana,45,47,86.0,0,0.04,2,315
2023-09-11,Primavera,90,91,86.0,0,0.01,1,630
2023-09-11,Napolitana,105,107,86.0,0,0.02,2,735
2023-09-12,Pepperoni,15,15,87.0,0,0.03,0,90
2023-09-12,Cheese,15,15,87.0,0,0.01,0,90
2023-09-12,Vegetariana,60,62,87.0,0,0.04,2,420
2023-09-12,Primavera,30,31,87.0,0,0.02,1,210
2023-09-12,Napolitana,60,61,87.0,0,0.02,1,420
2023-09-13,Pepperoni,30,31,89.0,1,0.02,1,180
2023-09-13,Cheese,15,15,89.0,1,0.02,0,90
2023-09-13,Vegetariana,135,139,89.0,1,0.03,4,945
2023-09-13,Primavera,15,16,89.0,1,0.04,1,105
2023-09-13,Napolitana,15,15,89.0,1,0.03,0,105
2023-09-14,Pepperoni,75,76,86.0,1,0.01,1,450
2023-09-14,Cheese,30,30,86.0,1,0.01,0,180
2023-09-14,Vegetariana,120,122,86.0,1,0.02,2,840
2023-09-14,Primavera,60,62,86.0,1,0.03,2,420
2023-09-14,Napolitana,15,15,86.0,1,0.02,0,105
2023-09-15,Pepperoni,210,212,84.5,1,0.01,2,1260
2023-09-15,Cheese,105,106,84.5,1,0.01,1,630
2023-09-15,Vegetariana,165,168,84.5,1,0.02,3,1155
2023-09-15,Primavera,45,46,84.5,1,0.02,1,315
2023-09-15,Napolitana,105,107,84.5,1,0.02,2,735
2023-09-16,Pepperoni,255,258,83.5,1,0.01,3,1530
2023-09-16,Cheese,45,45,83.5,1,0.01,0,270
2023-09-16,Vegetariana,15,15,83.5,1,0.02,0,105
2023-09-16,Primavera,90,92,83.5,1,0.02,2,630
2023-09-16,Napolitana,90,92,83.5,1,0.02,2,630
2023-09-17,Pepperoni,15,15,84.5,1,0.03,0,90
2023-09-17,Cheese,75,76,84.5,1,0.01,1,450
2023-09-17,Vegetariana,90,95,84.5,1,0.05,5,630
2023-09-17,Primavera,45,45,84.5,1,0.01,0,315
2023-09-17,Napolitana,15,15,84.5,1,0.02,0,105
2023-09-18,Pepperoni,75,77,85.5,1,0.02,2,450
2023-09-18,Cheese,105,106,85.5,1,0.01,1,630
2023-09-18,Vegetariana,45,47,85.5,1,0.04,2,315
2023-09-18,Primavera,30,30,85.5,1,0.01,0,210
2023-09-18,Napolitana,90,92,85.5,1,0.02,2,630
2023-09-19,Pepperoni,60,62,83.0,1,0.03,2,360
2023-09-19,Cheese,90,91,83.0,1,0.01,1,540
2023-09-19,Vegetariana,45,47,83.0,1,0.04,2,315
2023-09-19,Primavera,45,46,83.0,1,0.02,1,315
2023-09-19,Napolitana,15,15,83.0,1,0.02,0,105
2023-09-20,Pepperoni,45,46,85.0,1,0.02,1,270
2023-09-20,Cheese,30,31,85.0,1,0.02,1,180
2023-09-20,Vegetariana,60,62,85.0,1,0.03,2,420
2023-09-20,Primavera,60,62,85.0,1,0.04,2,420
2023-09-20,Napolitana,45,46,85.0,1,0.03,1,315
2023-09-21,Pepperoni,105,106,84.0,1,0.01,1,630
2023-09-21,Cheese,45,45,84.0,1,0.01,0,270
2023-09-21,Vegetariana,90,92,84.0,1,0.02,2,630
2023-09-21,Primavera,75,77,84.0,1,0.03,2,525
2023-09-21,Napolitana,90,92,84.0,1,0.02,2,630
2023-09-22,Pepperoni,345,348,83.5,1,0.01,3,2070
2023-09-22,Cheese,120,121,83.5,1,0.01,1,720
2023-09-22,Vegetariana,330,337,83.5,1,0.02,7,2310
2023-09-22,Primavera,165,168,83.5,1,0.02,3,1155
2023-09-22,Napolitana,135,138,83.5,1,0.02,3,945
2023-09-23,Pepperoni,120,121,81.0,1,0.01,1,720
2023-09-23,Cheese,165,167,81.0,1,0.01,2,990
2023-09-23,Vegetariana,150,153,81.0,1,0.02,3,1050
2023-09-23,Primavera,120,122,81.0,1,0.02,2,840
2023-09-23,Napolitana,60,61,81.0,1,0.02,1,420
2023-09-24,Pepperoni,30,31,81.5,1,0.03,1,180
2023-09-24,Cheese,30,30,81.5,1,0.01,0,180
2023-09-24,Vegetariana,90,95,81.5,1,0.05,5,630
2023-09-24,Primavera,90,91,81.5,1,0.01,1,630
2023-09-24,Napolitana,90,92,81.5,1,0.02,2,630
2023-09-25,Pepperoni,120,122,82.0,1,0.02,2,720
2023-09-25,Cheese,75,76,82.0,1,0.01,1,450
2023-09-25,Vegetariana,120,125,82.0,1,0.04,5,840
2023-09-25,Primavera,15,15,82.0,1,0.01,0,105
2023-09-25,Napolitana,15,15,82.0,1,0.02,0,105
2023-09-26,Pepperoni,30,31,84.5,1,0.03,1,180
2023-09-26,Cheese,60,61,84.5,1,0.01,1,360
2023-09-26,Vegetariana,45,47,84.5,1,0.04,2,315
2023-09-26,Primavera,45,46,84.5,1,0.02,1,315
2023-09-26,Napolitana,15,15,84.5,1,0.02,0,105
2023-09-27,Pepperoni,105,107,83.0,1,0.02,2,630
2023-09-27,Cheese,30,31,83.0,1,0.02,1,180
2023-09-27,Vegetariana,75,77,83.0,1,0.03,2,525
2023-09-27,Primavera,90,94,83.0,1,0.04,4,630
2023-09-27,Napolitana,30,31,83.0,1,0.03,1,210
2023-09-28,Pepperoni,75,76,84.0,1,0.01,1,450
2023-09-28,Cheese,75,76,84.0,1,0.01,1,450
2023-09-28,Vegetariana,105,107,84.0,1,0.02,2,735
2023-09-28,Primavera,90,93,84.0,1,0.03,3,630
2023-09-28,Napolitana,60,61,84.0,1,0.02,1,420
2023-09-29,Pepperoni,150,152,86.5,1,0.01,2,900
2023-09-29,Cheese,75,76,86.5,1,0.01,1,450
2023-09-29,Vegetariana,450,459,86.5,1,0.02,9,3150
2023-09-29,Primavera,90,92,86.5,1,0.02,2,630
2023-09-29,Napolitana,105,107,86.5,1,0.02,2,735
2023-09-30,Pepperoni,135,136,86.5,1,0.01,1,810
2023-09-30,Cheese,105,106,86.5,1,0.01,1,630
2023-09-30,Vegetariana,210,214,86.5,1,0.02,4,1470
2023-09-30,Primavera,105,107,86.5,1,0.02,2,735
2023-09-30,Napolitana,45,46,86.5,1,0.02,1,315
2023-10-01,Pepperoni,45,46,86.0,1,0.03,1,270
2023-10-01,Cheese,60,61,86.0,1,0.01,1,360
2023-10-01,Vegetariana,45,47,86.0,1,0.05,2,315
2023-10-01,Primavera,60,61,86.0,1,0.01,1,420
2023-10-01,Napolitana,30,31,86.0,1,0.02,1,210
2023-10-02,Pepperoni,60,61,82.5,1,0.02,1,360
2023-10-02,Cheese,15,15,82.5,1,0.01,0,90
2023-10-02,Vegetariana,30,31,82.5,1,0.04,1,210
2023-10-02,Primavera,15,15,82.5,1,0.01,0,105
2023-10-02,Napolitana,15,15,82.5,1,0.02,0,105
2023-10-03,Pepperoni,75,77,84.5,0,0.03,2,450
2023-10-03,Cheese,15,15,84.5,0,0.01,0,90
2023-10-03,Vegetariana,105,109,84.5,0,0.04,4,735
2023-10-03,Primavera,30,31,84.5,0,0.02,1,210
2023-10-03,Napolitana,15,15,84.5,0,0.02,0,105
2023-10-04,Pepperoni,30,31,84.0,0,0.02,1,180
2023-10-04,Cheese,60,61,84.0,0,0.02,1,360
2023-10-04,Vegetariana,15,15,84.0,0,0.03,0,105
2023-10-04,Primavera,90,94,84.0,0,0.04,4,630
2023-10-04,Napolitana,30,31,84.0,0,0.03,1,210
2023-10-05,Pepperoni,75,76,84.5,1,0.01,1,450
2023-10-05,Cheese,45,45,84.5,1,0.01,0,270
2023-10-05,Vegetariana,285,291,84.5,1,0.02,6,1995
2023-10-05,Primavera,105,108,84.5,1,0.03,3,735
2023-10-05,Napolitana,135,138,84.5,1,0.02,3,945
2023-10-06,Pepperoni,135,136,84.0,0,0.01,1,810
2023-10-06,Cheese,60,61,84.0,0,0.01,1,360
2023-10-06,Vegetariana,135,138,84.0,0,0.02,3,945
2023-10-06,Primavera,105,107,84.0,0,0.02,2,735
2023-10-06,Napolitana,120,122,84.0,0,0.02,2,840
2023-10-07,Pepperoni,210,212,85.0,1,0.01,2,1260
2023-10-07,Cheese,45,45,85.0,1,0.01,0,270
2023-10-07,Vegetariana,135,138,85.0,1,0.02,3,945
2023-10-07,Primavera,45,46,85.0,1,0.02,1,315
2023-10-07,Napolitana,60,61,85.0,1,0.02,1,420
2023-10-08,Pepperoni,75,77,83.5,1,0.03,2,450
2023-10-08,Cheese,15,15,83.5,1,0.01,0,90
2023-10-08,Vegetariana,30,32,83.5,1,0.05,2,210
2023-10-08,Primavera,30,30,83.5,1,0.01,0,210
2023-10-08,Napolitana,60,61,83.5,1,0.02,1,420
2023-10-09,Pepperoni,75,77,83.0,0,0.02,2,450
2023-10-09,Cheese,75,76,83.0,0,0.01,1,450
2023-10-09,Vegetariana,75,78,83.0,0,0.04,3,525
2023-10-09,Primavera,90,91,83.0,0,0.01,1,630
2023-10-09,Napolitana,45,46,83.0,0,0.02,1,315
2023-10-10,Pepperoni,90,93,84.5,0,0.03,3,540
2023-10-10,Cheese,105,106,84.5,0,0.01,1,630
2023-10-10,Vegetariana,60,62,84.5,0,0.04,2,420
2023-10-10,Primavera,15,15,84.5,0,0.02,0,105
2023-10-10,Napolitana,75,77,84.5,0,0.02,2,525
2023-10-11,Pepperoni,75,77,83.0,1,0.02,2,450
2023-10-11,Cheese,45,46,83.0,1,0.02,1,270
2023-10-11,Vegetariana,75,77,83.0,1,0.03,2,525
2023-10-11,Primavera,60,62,83.0,1,0.04,2,420
2023-10-11,Napolitana,45,46,83.0,1,0.03,1,315
2023-10-12,Pepperoni,105,106,88.5,0,0.01,1,630
2023-10-12,Cheese,75,76,88.5,0,0.01,1,450
2023-10-12,Vegetariana,45,46,88.5,0,0.02,1,315
2023-10-12,Primavera,45,46,88.5,0,0.03,1,315
2023-10-12,Napolitana,75,77,88.5,0,0.02,2,525
2023-10-13,Pepperoni,150,152,89.0,0,0.01,2,900
2023-10-13,Cheese,90,91,89.0,0,0.01,1,540
2023-10-13,Vegetariana,270,275,89.0,0,0.02,5,1890
2023-10-13,Primavera,165,168,89.0,0,0.02,3,1155
2023-10-13,Napolitana,30,31,89.0,0,0.02,1,210
2023-10-14,Pepperoni,240,242,83.5,1,0.01,2,1440
2023-10-14,Cheese,45,45,83.5,1,0.01,0,270
2023-10-14,Vegetariana,210,214,83.5,1,0.02,4,1470
2023-10-14,Primavera,180,184,83.5,1,0.02,4,1260
2023-10-14,Napolitana,75,77,83.5,1,0.02,2,525
2023-10-15,Pepperoni,45,46,83.0,0,0.03,1,270
2023-10-15,Cheese,15,15,83.0,0,0.01,0,90
2023-10-15,Vegetariana,60,63,83.0,0,0.05,3,420
2023-10-15,Primavera,45,45,83.0,0,0.01,0,315
2023-10-15,Napolitana,45,46,83.0,0,0.02,1,315
2023-10-16,Pepperoni,60,61,74.0,0,0.02,1,360
2023-10-16,Cheese,15,15,74.0,0,0.01,0,90
2023-10-16,Vegetariana,60,62,74.0,0,0.04,2,420
2023-10-16,Primavera,45,45,74.0,0,0.01,0,315
2023-10-16,Napolitana,60,61,74.0,0,0.02,1,420
2023-10-17,Pepperoni,60,62,70.0,0,0.03,2,360
2023-10-17,Cheese,60,61,70.0,0,0.01,1,360
2023-10-17,Vegetariana,105,109,70.0,0,0.04,4,735
2023-10-17,Primavera,60,61,70.0,0,0.02,1,420
2023-10-17,Napolitana,75,77,70.0,0,0.02,2,525
2023-10-18,Pepperoni,75,77,75.0,0,0.02,2,450
2023-10-18,Cheese,75,77,75.0,0,0.02,2,450
2023-10-18,Vegetariana,75,77,75.0,0,0.03,2,525
2023-10-18,Primavera,75,78,75.0,0,0.04,3,525
2023-10-18,Napolitana,45,46,75.0,0,0.03,1,315
2023-10-19,Pepperoni,90,91,79.0,0,0.01,1,540
2023-10-19,Cheese,30,30,79.0,0,0.01,0,180
2023-10-19,Vegetariana,120,122,79.0,0,0.02,2,840
2023-10-19,Primavera,90,93,79.0,0,0.03,3,630
2023-10-19,Napolitana,75,77,79.0,0,0.02,2,525
2023-10-20,Pepperoni,345,348,80.0,1,0.01,3,2070
2023-10-20,Cheese,60,61,80.0,1,0.01,1,360
2023-10-20,Vegetariana,330,337,80.0,1,0.02,7,2310
2023-10-20,Primavera,210,214,80.0,1,0.02,4,1470
2023-10-20,Napolitana,90,92,80.0,1,0.02,2,630
2023-10-21,Pepperoni,150,152,78.5,0,0.01,2,900
2023-10-21,Cheese,90,91,78.5,0,0.01,1,540
2023-10-21,Vegetariana,105,107,78.5,0,0.02,2,735
2023-10-21,Primavera,240,245,78.5,0,0.02,5,1680
2023-10-21,Napolitana,75,77,78.5,0,0.02,2,525
2023-10-22,Pepperoni,45,46,80.5,0,0.03,1,270
2023-10-22,Cheese,45,45,80.5,0,0.01,0,270
2023-10-22,Vegetariana,120,126,80.5,0,0.05,6,840
2023-10-22,Primavera,135,136,80.5,0,0.01,1,945
2023-10-22,Napolitana,90,92,80.5,0,0.02,2,630
2023-10-23,Pepperoni,90,92,78.0,0,0.02,2,540
2023-10-23,Cheese,105,106,78.0,0,0.01,1,630
2023-10-23,Vegetariana,135,140,78.0,0,0.04,5,945
2023-10-23,Primavera,45,45,78.0,0,0.01,0,315
2023-10-23,Napolitana,15,15,78.0,0,0.02,0,105
2023-10-24,Pepperoni,75,77,81.5,1,0.03,2,450
2023-10-24,Cheese,120,121,81.5,1,0.01,1,720
2023-10-24,Vegetariana,15,16,81.5,1,0.04,1,105
2023-10-24,Primavera,90,92,81.5,1,0.02,2,630
2023-10-24,Napolitana,15,15,81.5,1,0.02,0,105
2023-10-25,Pepperoni,60,61,82.0,1,0.02,1,360
2023-10-25,Cheese,30,31,82.0,1,0.02,1,180
2023-10-25,Vegetariana,135,139,82.0,1,0.03,4,945
2023-10-25,Primavera,120,125,82.0,1,0.04,5,840
2023-10-25,Napolitana,15,15,82.0,1,0.03,0,105
2023-10-26,Pepperoni,90,91,82.0,1,0.01,1,540
2023-10-26,Cheese,60,61,82.0,1,0.01,1,360
2023-10-26,Vegetariana,180,184,82.0,1,0.02,4,1260
2023-10-26,Primavera,120,124,82.0,1,0.03,4,840
2023-10-26,Napolitana,30,31,82.0,1,0.02,1,210
2023-10-27,Pepperoni,240,242,82.0,1,0.01,2,1440
2023-10-27,Cheese,90,91,82.0,1,0.01,1,540
2023-10-27,Vegetariana,255,260,82.0,1,0.02,5,1785
2023-10-27,Primavera,135,138,82.0,1,0.02,3,945
2023-10-27,Napolitana,75,77,82.0,1,0.02,2,525
2023-10-28,Pepperoni,315,318,82.5,1,0.01,3,1890
2023-10-28,Cheese,75,76,82.5,1,0.01,1,450
2023-10-28,Vegetariana,150,153,82.5,1,0.02,3,1050
2023-10-28,Primavera,165,168,82.5,1,0.02,3,1155
2023-10-28,Napolitana,135,138,82.5,1,0.02,3,945
2023-10-29,Pepperoni,75,77,82.5,1,0.03,2,450
2023-10-29,Cheese,15,15,82.5,1,0.01,0,90
2023-10-29,Vegetariana,105,110,82.5,1,0.05,5,735
2023-10-29,Primavera,30,30,82.5,1,0.01,0,210
2023-10-29,Napolitana,15,15,82.5,1,0.02,0,105
2023-10-30,Pepperoni,60,61,83.5,0,0.02,1,360
2023-10-30,Cheese,90,91,83.5,0,0.01,1,540
2023-10-30,Vegetariana,60,62,83.5,0,0.04,2,420
2023-10-30,Primavera,15,15,83.5,0,0.01,0,105
2023-10-30,Napolitana,15,15,83.5,0,0.02,0,105
2023-10-31,Pepperoni,60,62,83.5,0,0.03,2,360
2023-10-31,Cheese,60,61,83.5,0,0.01,1,360
2023-10-31,Vegetariana,165,172,83.5,0,0.04,7,1155
2023-10-31,Primavera,75,77,83.5,0,0.02,2,525
2023-10-31,Napolitana,15,15,83.5,0,0.02,0,105
2023-11-01,Pepperoni,60,61,79.5,1,0.02,1,360
2023-11-01,Cheese,30,31,79.5,1,0.02,1,180
2023-11-01,Vegetariana,60,62,79.5,1,0.03,2,420
2023-11-01,Primavera,30,31,79.5,1,0.04,1,210
2023-11-01,Napolitana,90,93,79.5,1,0.03,3,630
2023-11-02,Pepperoni,60,61,76.5,1,0.01,1,360
2023-11-02,Cheese,30,30,76.5,1,0.01,0,180
2023-11-02,Vegetariana,90,92,76.5,1,0.02,2,630
2023-11-02,Primavera,120,124,76.5,1,0.03,4,840
2023-11-02,Napolitana,75,77,76.5,1,0.02,2,525
2023-11-03,Pepperoni,180,182,80.0,1,0.01,2,1080
2023-11-03,Cheese,90,91,80.0,1,0.01,1,540
2023-11-03,Vegetariana,255,260,80.0,1,0.02,5,1785
2023-11-03,Primavera,165,168,80.0,1,0.02,3,1155
2023-11-03,Napolitana,30,31,80.0,1,0.02,1,210
2023-11-04,Pepperoni,120,121,79.0,1,0.01,1,720
2023-11-04,Cheese,90,91,79.0,1,0.01,1,540
2023-11-04,Vegetariana,225,230,79.0,1,0.02,5,1575
2023-11-04,Primavera,225,230,79.0,1,0.02,5,1575
2023-11-04,Napolitana,90,92,79.0,1,0.02,2,630
2023-11-05,Pepperoni,195,201,78.5,0,0.03,6,1170
2023-11-05,Cheese,90,91,78.5,0,0.01,1,540
2023-11-05,Vegetariana,75,79,78.5,0,0.05,4,525
2023-11-05,Primavera,30,30,78.5,0,0.01,0,210
2023-11-05,Napolitana,15,15,78.5,0,0.02,0,105
2023-11-06,Pepperoni,45,46,77.0,0,0.02,1,270
2023-11-06,Cheese,45,45,77.0,0,0.01,0,270
2023-11-06,Vegetariana,90,94,77.0,0,0.04,4,630
2023-11-06,Primavera,60,61,77.0,0,0.01,1,420
2023-11-06,Napolitana,15,15,77.0,0,0.02,0,105
2023-11-07,Pepperoni,90,93,79.5,0,0.03,3,540
2023-11-07,Cheese,75,76,79.5,0,0.01,1,450
2023-11-07,Vegetariana,75,78,79.5,0,0.04,3,525
2023-11-07,Primavera,60,61,79.5,0,0.02,1,420
2023-11-07,Napolitana,15,15,79.5,0,0.02,0,105
2023-11-08,Pepperoni,60,61,78.5,1,0.02,1,360
2023-11-08,Cheese,60,61,78.5,1,0.02,1,360
2023-11-08,Vegetariana,75,77,78.5,1,0.03,2,525
2023-11-08,Primavera,30,31,78.5,1,0.04,1,210
2023-11-08,Napolitana,15,15,78.5,1,0.03,0,105
2023-11-09,Pepperoni,30,30,80.5,1,0.01,0,180
2023-11-09,Cheese,30,30,80.5,1,0.01,0,180
2023-11-09,Vegetariana,105,107,80.5,1,0.02,2,735
2023-11-09,Primavera,60,62,80.5,1,0.03,2,420
2023-11-09,Napolitana,60,61,80.5,1,0.02,1,420
2023-11-10,Pepperoni,285,288,82.5,0,0.01,3,1710
2023-11-10,Cheese,45,45,82.5,0,0.01,0,270
2023-11-10,Vegetariana,300,306,82.5,0,0.02,6,2100
2023-11-10,Primavera,75,77,82.5,0,0.02,2,525
2023-11-10,Napolitana,150,153,82.5,0,0.02,3,1050
2023-11-11,Pepperoni,105,106,84.5,0,0.01,1,630
2023-11-11,Cheese,150,152,84.5,0,0.01,2,900
2023-11-11,Vegetariana,210,214,84.5,0,0.02,4,1470
2023-11-11,Primavera,135,138,84.5,0,0.02,3,945
2023-11-11,Napolitana,105,107,84.5,0,0.02,2,735
2023-11-12,Pepperoni,90,93,82.0,0,0.03,3,540
2023-11-12,Cheese,30,30,82.0,0,0.01,0,180
2023-11-12,Vegetariana,195,205,82.0,0,0.05,10,1365
2023-11-12,Primavera,90,91,82.0,0,0.01,1,630
2023-11-12,Napolitana,90,92,82.0,0,0.02,2,630
2023-11-13,Pepperoni,45,46,81.0,1,0.02,1,270
2023-11-13,Cheese,30,30,81.0,1,0.01,0,180
2023-11-13,Vegetariana,90,94,81.0,1,0.04,4,630
2023-11-13,Primavera,30,30,81.0,1,0.01,0,210
2023-11-13,Napolitana,15,15,81.0,1,0.02,0,105
2023-11-14,Pepperoni,30,31,79.0,1,0.03,1,180
2023-11-14,Cheese,30,30,79.0,1,0.01,0,180
2023-11-14,Vegetariana,60,62,79.0,1,0.04,2,420
2023-11-14,Primavera,45,46,79.0,1,0.02,1,315
2023-11-14,Napolitana,15,15,79.0,1,0.02,0,105
2023-11-15,Pepperoni,75,77,75.0,1,0.02,2,450
2023-11-15,Cheese,75,77,75.0,1,0.02,2,450
2023-11-15,Vegetariana,105,108,75.0,1,0.03,3,735
2023-11-15,Primavera,75,78,75.0,1,0.04,3,525
2023-11-15,Napolitana,30,31,75.0,1,0.03,1,210
2023-11-16,Pepperoni,60,61,74.5,1,0.01,1,360
2023-11-16,Cheese,60,61,74.5,1,0.01,1,360
2023-11-16,Vegetariana,75,77,74.5,1,0.02,2,525
2023-11-16,Primavera,60,62,74.5,1,0.03,2,420
2023-11-16,Napolitana,30,31,74.5,1,0.02,1,210
2023-11-17,Pepperoni,75,76,78.5,0,0.01,1,450
2023-11-17,Cheese,60,61,78.5,0,0.01,1,360
2023-11-17,Vegetariana,210,214,78.5,0,0.02,4,1470
2023-11-17,Primavera,120,122,78.5,0,0.02,2,840
2023-11-17,Napolitana,75,77,78.5,0,0.02,2,525
2023-11-18,Pepperoni,240,242,75.5,0,0.01,2,1440
2023-11-18,Cheese,75,76,75.5,0,0.01,1,450
2023-11-18,Vegetariana,105,107,75.5,0,0.02,2,735
2023-11-18,Primavera,120,122,75.5,0,0.02,2,840
2023-11-18,Napolitana,105,107,75.5,0,0.02,2,735
2023-11-19,Pepperoni,30,31,77.5,1,0.03,1,180
2023-11-19,Cheese,30,30,77.5,1,0.01,0,180
2023-11-19,Vegetariana,90,95,77.5,1,0.05,5,630
2023-11-19,Primavera,45,45,77.5,1,0.01,0,315
2023-11-19,Napolitana,30,31,77.5,1,0.02,1,210
2023-11-20,Pepperoni,60,61,77.5,1,0.02,1,360
2023-11-20,Cheese,30,30,77.5,1,0.01,0,180
2023-11-20,Vegetariana,45,47,77.5,1,0.04,2,315
2023-11-20,Primavera,15,15,77.5,1,0.01,0,105
2023-11-20,Napolitana,45,46,77.5,1,0.02,1,315
2023-11-21,Pepperoni,75,77,80.5,0,0.03,2,450
2023-11-21,Cheese,15,15,80.5,0,0.01,0,90
2023-11-21,Vegetariana,90,94,80.5,0,0.04,4,630
2023-11-21,Primavera,75,77,80.5,0,0.02,2,525
2023-11-21,Napolitana,60,61,80.5,0,0.02,1,420
2023-11-22,Pepperoni,15,15,78.5,0,0.02,0,90
2023-11-22,Cheese,15,15,78.5,0,0.02,0,90
2023-11-22,Vegetariana,60,62,78.5,0,0.03,2,420
2023-11-22,Primavera,60,62,78.5,0,0.04,2,420
2023-11-22,Napolitana,15,15,78.5,0,0.03,0,105
2023-11-23,Pepperoni,120,121,79.0,0,0.01,1,720
2023-11-23,Cheese,60,61,79.0,0,0.01,1,360
2023-11-23,Vegetariana,90,92,79.0,0,0.02,2,630
2023-11-23,Primavera,60,62,79.0,0,0.03,2,420
2023-11-23,Napolitana,60,61,79.0,0,0.02,1,420
2023-11-24,Pepperoni,315,318,77.0,1,0.01,3,1890
2023-11-24,Cheese,30,30,77.0,1,0.01,0,180
2023-11-24,Vegetariana,285,291,77.0,1,0.02,6,1995
2023-11-24,Primavera,165,168,77.0,1,0.02,3,1155
2023-11-24,Napolitana,165,168,77.0,1,0.02,3,1155
2023-11-25,Pepperoni,105,106,78.0,1,0.01,1,630
2023-11-25,Cheese,60,61,78.0,1,0.01,1,360
2023-11-25,Vegetariana,120,122,78.0,1,0.02,2,840
2023-11-25,Primavera,75,77,78.0,1,0.02,2,525
2023-11-25,Napolitana,75,77,78.0,1,0.02,2,525
2023-11-26,Pepperoni,45,46,80.0,1,0.03,1,270
2023-11-26,Cheese,75,76,80.0,1,0.01,1,450
2023-11-26,Vegetariana,75,79,80.0,1,0.05,4,525
2023-11-26,Primavera,60,61,80.0,1,0.01,1,420
2023-11-26,Napolitana,90,92,80.0,1,0.02,2,630
2023-11-27,Pepperoni,45,46,75.0,0,0.02,1,270
2023-11-27,Cheese,30,30,75.0,0,0.01,0,180
2023-11-27,Vegetariana,90,94,75.0,0,0.04,4,630
2023-11-27,Primavera,105,106,75.0,0,0.01,1,735
2023-11-27,Napolitana,15,15,75.0,0,0.02,0,105
2023-11-28,Pepperoni,30,31,70.5,0,0.03,1,180
2023-11-28,Cheese,90,91,70.5,0,0.01,1,540
2023-11-28,Vegetariana,15,16,70.5,0,0.04,1,105
2023-11-28,Primavera,120,122,70.5,0,0.02,2,840
2023-11-28,Napolitana,15,15,70.5,0,0.02,0,105
2023-11-29,Pepperoni,45,46,68.0,0,0.02,1,270
2023-11-29,Cheese,105,107,68.0,0,0.02,2,630
2023-11-29,Vegetariana,105,108,68.0,0,0.03,3,735
2023-11-29,Primavera,15,16,68.0,0,0.04,1,105
2023-11-29,Napolitana,30,31,68.0,0,0.03,1,210
2023-11-30,Pepperoni,210,212,72.0,0,0.01,2,1260
2023-11-30,Cheese,105,106,72.0,0,0.01,1,630
2023-11-30,Vegetariana,225,230,72.0,0,0.02,5,1575
2023-11-30,Primavera,225,232,72.0,0,0.03,7,1575
2023-11-30,Napolitana,60,61,72.0,0,0.02,1,420
2023-12-01,Pepperoni,195,197,76.5,0,0.01,2,1170
2023-12-01,Cheese,75,76,76.5,0,0.01,1,450
2023-12-01,Vegetariana,240,245,76.5,0,0.02,5,1680
2023-12-01,Primavera,180,184,76.5,0,0.02,4,1260
2023-12-01,Napolitana,60,61,76.5,0,0.02,1,420
2023-12-02,Pepperoni,225,227,81.5,0,0.01,2,1350
2023-12-02,Cheese,30,30,81.5,0,0.01,0,180
2023-12-02,Vegetariana,105,107,81.5,0,0.02,2,735
2023-12-02,Primavera,105,107,81.5,0,0.02,2,735
2023-12-02,Napolitana,45,46,81.5,0,0.02,1,315
2023-12-03,Pepperoni,30,31,81.0,0,0.03,1,180
2023-12-03,Cheese,15,15,81.0,0,0.01,0,90
2023-12-03,Vegetariana,45,47,81.0,0,0.05,2,315
2023-12-03,Primavera,90,91,81.0,0,0.01,1,630
2023-12-03,Napolitana,60,61,81.0,0,0.02,1,420
2023-12-04,Pepperoni,45,46,79.0,0,0.02,1,270
2023-12-04,Cheese,90,91,79.0,0,0.01,1,540
2023-12-04,Vegetariana,30,31,79.0,0,0.04,1,210
2023-12-04,Primavera,45,45,79.0,0,0.01,0,315
2023-12-04,Napolitana,75,77,79.0,0,0.02,2,525
2023-12-05,Pepperoni,15,15,76.5,0,0.03,0,90
2023-12-05,Cheese,45,45,76.5,0,0.01,0,270
2023-12-05,Vegetariana,75,78,76.5,0,0.04,3,525
2023-12-05,Primavera,45,46,76.5,0,0.02,1,315
2023-12-05,Napolitana,30,31,76.5,0,0.02,1,210
2023-12-06,Pepperoni,150,153,65.5,0,0.02,3,900
2023-12-06,Cheese,90,92,65.5,0,0.02,2,540
2023-12-06,Vegetariana,120,124,65.5,0,0.03,4,840
2023-12-06,Primavera,90,94,65.5,0,0.04,4,630
2023-12-06,Napolitana,60,62,65.5,0,0.03,2,420
2023-12-07,Pepperoni,150,152,66.0,0,0.01,2,900
2023-12-07,Cheese,60,61,66.0,0,0.01,1,360
2023-12-07,Vegetariana,225,230,66.0,0,0.02,5,1575
2023-12-07,Primavera,75,77,66.0,0,0.03,2,525
2023-12-07,Napolitana,30,31,66.0,0,0.02,1,210
2023-12-08,Pepperoni,255,258,71.5,0,0.01,3,1530
2023-12-08,Cheese,75,76,71.5,0,0.01,1,450
2023-12-08,Vegetariana,435,444,71.5,0,0.02,9,3045
2023-12-08,Primavera,150,153,71.5,0,0.02,3,1050
2023-12-08,Napolitana,75,77,71.5,0,0.02,2,525
2023-12-09,Pepperoni,225,227,78.5,0,0.01,2,1350
2023-12-09,Cheese,15,15,78.5,0,0.01,0,90
2023-12-09,Vegetariana,270,275,78.5,0,0.02,5,1890
2023-12-09,Primavera,150,153,78.5,0,0.02,3,1050
2023-12-09,Napolitana,75,77,78.5,0,0.02,2,525
2023-12-10,Pepperoni,120,124,76.5,1,0.03,4,720
2023-12-10,Cheese,15,15,76.5,1,0.01,0,90
2023-12-10,Vegetariana,45,47,76.5,1,0.05,2,315
2023-12-10,Primavera,30,30,76.5,1,0.01,0,210
2023-12-10,Napolitana,30,31,76.5,1,0.02,1,210
2023-12-11,Pepperoni,60,61,67.0,0,0.02,1,360
2023-12-11,Cheese,15,15,67.0,0,0.01,0,90
2023-12-11,Vegetariana,90,94,67.0,0,0.04,4,630
2023-12-11,Primavera,45,45,67.0,0,0.01,0,315
2023-12-11,Napolitana,105,107,67.0,0,0.02,2,735
2023-12-12,Pepperoni,90,93,68.0,1,0.03,3,540
2023-12-12,Cheese,75,76,68.0,1,0.01,1,450
2023-12-12,Vegetariana,105,109,68.0,1,0.04,4,735
2023-12-12,Primavera,75,77,68.0,1,0.02,2,525
2023-12-12,Napolitana,60,61,68.0,1,0.02,1,420
2023-12-13,Pepperoni,15,15,73.5,1,0.02,0,90
2023-12-13,Cheese,60,61,73.5,1,0.02,1,360
2023-12-13,Vegetariana,60,62,73.5,1,0.03,2,420
2023-12-13,Primavera,45,47,73.5,1,0.04,2,315
2023-12-13,Napolitana,30,31,73.5,1,0.03,1,210
2023-12-14,Pepperoni,105,106,72.0,1,0.01,1,630
2023-12-14,Cheese,60,61,72.0,1,0.01,1,360
2023-12-14,Vegetariana,90,92,72.0,1,0.02,2,630
2023-12-14,Primavera,45,46,72.0,1,0.03,1,315
2023-12-14,Napolitana,75,77,72.0,1,0.02,2,525
2023-12-15,Pepperoni,150,152,71.0,1,0.01,2,900
2023-12-15,Cheese,90,91,71.0,1,0.01,1,540
2023-12-15,Vegetariana,240,245,71.0,1,0.02,5,1680
2023-12-15,Primavera,105,107,71.0,1,0.02,2,735
2023-12-15,Napolitana,75,77,71.0,1,0.02,2,525
2023-12-16,Pepperoni,120,121,73.5,1,0.01,1,720
2023-12-16,Cheese,30,30,73.5,1,0.01,0,180
2023-12-16,Vegetariana,240,245,73.5,1,0.02,5,1680
2023-12-16,Primavera,75,77,73.5,1,0.02,2,525
2023-12-16,Napolitana,75,77,73.5,1,0.02,2,525
2023-12-17,Pepperoni,90,93,72.0,1,0.03,3,540
2023-12-17,Cheese,15,15,72.0,1,0.01,0,90
2023-12-17,Vegetariana,75,79,72.0,1,0.05,4,525
2023-12-17,Primavera,165,167,72.0,1,0.01,2,1155
2023-12-17,Napolitana,15,15,72.0,1,0.02,0,105
2023-12-18,Pepperoni,75,77,67.0,0,0.02,2,450
2023-12-18,Cheese,60,61,67.0,0,0.01,1,360
2023-12-18,Vegetariana,45,47,67.0,0,0.04,2,315
2023-12-18,Primavera,75,76,67.0,0,0.01,1,525
2023-12-18,Napolitana,90,92,67.0,0,0.02,2,630
2023-12-19,Pepperoni,75,77,64.0,0,0.03,2,450
2023-12-19,Cheese,15,15,64.0,0,0.01,0,90
2023-12-19,Vegetariana,105,109,64.0,0,0.04,4,735
2023-12-19,Primavera,90,92,64.0,0,0.02,2,630
2023-12-19,Napolitana,15,15,64.0,0,0.02,0,105
2023-12-20,Pepperoni,45,46,64.0,0,0.02,1,270
2023-12-20,Cheese,30,31,64.0,0,0.02,1,180
2023-12-20,Vegetariana,90,93,64.0,0,0.03,3,630
2023-12-20,Primavera,75,78,64.0,0,0.04,3,525
2023-12-20,Napolitana,15,15,64.0,0,0.03,0,105
2023-12-21,Pepperoni,165,167,73.0,0,0.01,2,990
2023-12-21,Cheese,45,45,73.0,0,0.01,0,270
2023-12-21,Vegetariana,105,107,73.0,0,0.02,2,735
2023-12-21,Primavera,105,108,73.0,0,0.03,3,735
2023-12-21,Napolitana,75,77,73.0,0,0.02,2,525
2023-12-22,Pepperoni,180,182,71.0,0,0.01,2,1080
2023-12-22,Cheese,105,106,71.0,0,0.01,1,630
2023-12-22,Vegetariana,180,184,71.0,0,0.02,4,1260
2023-12-22,Primavera,135,138,71.0,0,0.02,3,945
2023-12-22,Napolitana,120,122,71.0,0,0.02,2,840
2023-12-23,Pepperoni,150,152,72.0,1,0.01,2,900
2023-12-23,Cheese,105,106,72.0,1,0.01,1,630
2023-12-23,Vegetariana,120,122,72.0,1,0.02,2,840
2023-12-23,Primavera,120,122,72.0,1,0.02,2,840
2023-12-23,Napolitana,60,61,72.0,1,0.02,1,420
2023-12-24,Pepperoni,150,155,74.0,1,0.03,5,900
2023-12-24,Cheese,30,30,74.0,1,0.01,0,180
2023-12-24,Vegetariana,75,79,74.0,1,0.05,4,525
2023-12-24,Primavera,75,76,74.0,1,0.01,1,525
2023-12-24,Napolitana,105,107,74.0,1,0.02,2,735
2023-12-25,Pepperoni,75,77,74.0,1,0.02,2,450
2023-12-25,Cheese,75,76,74.0,1,0.01,1,450
2023-12-25,Vegetariana,60,62,74.0,1,0.04,2,420
2023-12-25,Primavera,45,45,74.0,1,0.01,0,315
2023-12-25,Napolitana,30,31,74.0,1,0.02,1,210
2023-12-26,Pepperoni,90,93,76.0,1,0.03,3,540
2023-12-26,Cheese,45,45,76.0,1,0.01,0,270
2023-12-26,Vegetariana,105,109,76.0,1,0.04,4,735
2023-12-26,Primavera,15,15,76.0,1,0.02,0,105
2023-12-26,Napolitana,15,15,76.0,1,0.02,0,105
2023-12-27,Pepperoni,150,153,71.0,0,0.02,3,900
2023-12-27,Cheese,75,77,71.0,0,0.02,2,450
2023-12-27,Vegetariana,45,46,71.0,0,0.03,1,315
2023-12-27,Primavera,45,47,71.0,0,0.04,2,315
2023-12-27,Napolitana,30,31,71.0,0,0.03,1,210
2023-12-28,Pepperoni,105,106,64.0,1,0.01,1,630
2023-12-28,Cheese,15,15,64.0,1,0.01,0,90
2023-12-28,Vegetariana,195,199,64.0,1,0.02,4,1365
2023-12-28,Primavera,150,155,64.0,1,0.03,5,1050
2023-12-28,Napolitana,15,15,64.0,1,0.02,0,105
2023-12-29,Pepperoni,75,76,65.0,0,0.01,1,450
2023-12-29,Cheese,120,121,65.0,0,0.01,1,720
2023-12-29,Vegetariana,270,275,65.0,0,0.02,5,1890
2023-12-29,Primavera,90,92,65.0,0,0.02,2,630
2023-12-29,Napolitana,120,122,65.0,0,0.02,2,840
2023-12-30,Pepperoni,300,303,61.5,0,0.01,3,1800
2023-12-30,Cheese,60,61,61.5,0,0.01,1,360
2023-12-30,Vegetariana,135,138,61.5,0,0.02,3,945
2023-12-30,Primavera,135,138,61.5,0,0.02,3,945
2023-12-30,Napolitana,30,31,61.5,0,0.02,1,210
2023-12-31,Pepperoni,300,309,62.5,0,0.03,9,1800
2023-12-31,Cheese,90,91,62.5,0,0.01,1,540
2023-12-31,Vegetariana,75,79,62.5,0,0.05,4,525
2023-12-31,Primavera,60,61,62.5,0,0.01,1,420
2023-12-31,Napolitana,45,46,62.5,0,0.02,1,315
